"aa" = (/obj/structure/barricade,/obj/structure/barbwire,/obj/structure/barbwire{tag = "icon-barbwire (WEST)"; icon_state = "barbwire"; dir = 8},/turf/wall/wood,/area/prishtina/german/ss_armory)
"ab" = (/obj/effect/decal/cleanable/dirt,/obj/structure/barricade,/obj/structure/barbwire,/turf/wall/wood,/area/prishtina/german/ss_armory)
"ac" = (/obj/structure/barricade,/obj/structure/barbwire,/turf/wall/wood,/area/prishtina/german/ss_armory)
"ad" = (/obj/structure/barricade,/obj/structure/barbwire{tag = "icon-barbwire (WEST)"; icon_state = "barbwire"; dir = 8},/turf/wall/wood,/area/prishtina/german/ss_armory)
"ae" = (/obj/structure/multiz/ladder/ww2{area_id = "SS_ladder"},/turf/floor/wood,/area/prishtina/german/ss_armory)
"af" = (/obj/item/weapon/handcuffs,/obj/item/weapon/storage/belt/security/tactical,/obj/item/weapon/storage/backpack/german,/obj/item/weapon/key/german/SS,/obj/structure/closet,/obj/item/weapon/storage/box/handcuffs,/obj/item/clothing/accessory/armband,/obj/item/clothing/suit/storage/coat/german/SS,/obj/item/clothing/accessory/armband,/obj/item/clothing/suit/storage/coat/german/SS,/obj/item/weapon/melee/classic_baton/MP/SS,/turf/floor/wood,/area/prishtina/german/ss_armory)
"ag" = (/obj/item/weapon/handcuffs,/obj/item/weapon/storage/belt/security/tactical,/obj/item/weapon/storage/backpack/german,/obj/item/weapon/key/german/SS,/obj/structure/closet,/obj/item/weapon/storage/box/handcuffs,/obj/item/clothing/accessory/armband,/obj/structure/sign/flag/germany{pixel_y = 30},/obj/item/clothing/suit/storage/coat/german/SS,/obj/item/clothing/accessory/armband,/obj/item/clothing/suit/storage/coat/german/SS,/obj/item/weapon/melee/classic_baton/MP/SS,/turf/floor/wood,/area/prishtina/german/ss_armory)
"ah" = (/turf/floor/wood,/area/prishtina/german/ss_armory)
"ai" = (/obj/structure/vending/SSequipment,/turf/floor/wood,/area/prishtina/german/ss_armory)
"aj" = (/obj/structure/barricade,/obj/structure/barbwire{tag = "icon-barbwire (EAST)"; icon_state = "barbwire"; dir = 4},/turf/wall/wood,/area/prishtina/german/ss_armory)
"am" = (/obj/structure/bed,/obj/item/weapon/bedsheet/green,/obj/machinery/light/small{dir = 1},/turf/floor/wood,/area/prishtina/german/ss_armory)
"an" = (/obj/structure/table/rack,/turf/floor/wood,/area/prishtina/german/ss_armory)
"ao" = (/obj/structure/bed,/obj/item/weapon/bedsheet/green,/turf/floor/wood,/area/prishtina/german/ss_armory)
"ap" = (/obj/machinery/light/small{dir = 1},/turf/floor/wood,/area/prishtina/german/ss_armory)
"aq" = (/obj/structure/closet/crate/lugers,/turf/floor/wood,/area/prishtina/german/ss_armory)
"ar" = (/obj/machinery/light/small,/obj/structure/closet,/obj/item/weapon/material/kitchen/utensil/knife/boot,/obj/item/weapon/wirecutters,/turf/floor/wood,/area/prishtina/german/ss_armory)
"as" = (/obj/structure/table/rack,/obj/item/weapon/flammenwerfer_fueltank,/obj/item/weapon/flammenwerfer_fueltank,/obj/item/weapon/flammenwerfer_fueltank,/obj/item/weapon/storage/backpack/flammenwerfer,/turf/floor/wood,/area/prishtina/german/ss_armory)
"at" = (/obj/item/weapon/gun/projectile/boltaction/kar98k,/obj/item/weapon/attachment/scope/adjustable/sniper_scope,/obj/item/ammo_magazine/kar98k,/obj/item/ammo_magazine/kar98k,/obj/item/ammo_magazine/kar98k,/obj/item/ammo_magazine/kar98k,/obj/item/ammo_magazine/kar98k,/obj/structure/closet,/turf/floor/wood,/area/prishtina/german/ss_armory)
"au" = (/obj/structure/closet/crate/lugerammo,/turf/floor/wood,/area/prishtina/german/ss_armory)
"av" = (/obj/structure/closet,/obj/item/ammo_magazine/mp40,/obj/item/ammo_magazine/mp40,/obj/item/ammo_magazine/mp40,/obj/item/ammo_magazine/mp40,/obj/item/weapon/gun/projectile/automatic/mp40,/turf/floor/wood,/area/prishtina/german/ss_armory)
"aw" = (/obj/structure/bed,/obj/item/weapon/bedsheet/blue,/turf/floor/carpet,/area/prishtina/german/ss_armory)
"ax" = (/obj/machinery/light/small{dir = 1},/turf/floor/carpet,/area/prishtina/german/ss_armory)
"ay" = (/obj/structure/closet/cabinet,/obj/item/clothing/under/geruni/ssformalofc,/obj/item/weapon/storage/backpack/satchel,/obj/item/weapon/gun/projectile/pistol/luger,/obj/item/ammo_magazine/luger,/turf/floor/carpet,/area/prishtina/german/ss_armory)
"az" = (/obj/structure/bookcase,/turf/floor/carpet,/area/prishtina/german/ss_armory)
"aA" = (/turf/wall/wood,/area/prishtina/german/ss_armory)
"aB" = (/turf/floor/carpet,/area/prishtina/german/ss_armory)
"aC" = (/obj/structure/simple_door/key_door/german/command_intermediate{name = "SS Officer Quarters"},/turf/floor/tiled/white,/area/prishtina/german/ss_armory)
"aD" = (/turf/floor/tiled/white,/area/prishtina/german/ss_armory)
"aE" = (/obj/machinery/light/small{dir = 4},/obj/structure/toilet,/turf/floor/tiled/white,/area/prishtina/german/ss_armory)
"aF" = (/obj/effect/landmark{name = "JoinLateSS-Officer"},/turf/floor/carpet,/area/prishtina/german/ss_armory)
"aG" = (/obj/structure/bed/chair/comfy,/obj/machinery/light/small{dir = 4},/turf/floor/carpet,/area/prishtina/german/ss_armory)
"aH" = (/obj/machinery/light/small,/turf/floor/tiled/white,/area/prishtina/german/ss_armory)
"aI" = (/obj/machinery/light/small{dir = 4},/turf/floor/carpet,/area/prishtina/german/ss_armory)
"aJ" = (/obj/structure/table/wood,/turf/floor/carpet,/area/prishtina/german/ss_armory)
"aK" = (/obj/machinery/light/small,/turf/floor/wood,/area/prishtina/german/ss_armory)
"aL" = (/obj/structure/bed/chair/comfy{dir = 4},/turf/floor/carpet,/area/prishtina/german/ss_armory)
"aM" = (/obj/structure/table/wood,/obj/machinery/light/small,/turf/floor/carpet,/area/prishtina/german/ss_armory)
"aN" = (/obj/structure/table/wood,/obj/item/clothing/accessory/medal/WW2/iron_cross_first_class,/obj/item/clothing/accessory/medal/WW2/iron_cross_first_class,/obj/item/clothing/accessory/medal/WW2/iron_cross_first_class,/obj/item/clothing/accessory/medal/WW2/iron_cross_first_class,/obj/item/clothing/accessory/medal/WW2/iron_cross_first_class,/obj/item/clothing/accessory/medal/WW2/iron_cross_first_class,/obj/item/clothing/accessory/medal/WW2/iron_cross_first_class,/obj/item/clothing/accessory/medal/WW2/iron_cross_first_class,/obj/item/clothing/accessory/medal/WW2/iron_cross_first_class,/obj/item/clothing/accessory/medal/WW2/iron_cross_first_class,/obj/item/clothing/accessory/medal/WW2/iron_cross_first_class,/obj/item/clothing/accessory/medal/WW2/iron_cross_first_class,/obj/item/clothing/accessory/medal/WW2/iron_cross_first_class,/obj/item/clothing/accessory/medal/WW2/iron_cross_first_class,/obj/item/clothing/accessory/medal/WW2/iron_cross_first_class,/obj/item/clothing/accessory/medal/WW2/iron_cross_first_class,/obj/item/clothing/accessory/medal/WW2/iron_cross_first_class,/obj/item/clothing/accessory/medal/WW2/iron_cross_second_class,/obj/item/clothing/accessory/medal/WW2/iron_cross_second_class,/obj/item/clothing/accessory/medal/WW2/iron_cross_second_class,/obj/item/clothing/accessory/medal/WW2/iron_cross_second_class,/obj/item/clothing/accessory/medal/WW2/iron_cross_second_class,/obj/item/clothing/accessory/medal/WW2/iron_cross_second_class,/obj/item/clothing/accessory/medal/WW2/iron_cross_second_class,/obj/item/clothing/accessory/medal/WW2/iron_cross_second_class,/obj/item/clothing/accessory/medal/WW2/iron_cross_second_class,/obj/item/clothing/accessory/medal/WW2/iron_cross_second_class,/obj/item/clothing/accessory/medal/WW2/iron_cross_second_class,/obj/item/clothing/accessory/medal/WW2/iron_cross_second_class,/obj/item/clothing/accessory/medal/WW2/iron_cross_second_class,/obj/item/clothing/accessory/medal/WW2/iron_cross_second_class,/obj/item/clothing/accessory/medal/WW2/iron_cross_second_class,/obj/item/clothing/accessory/medal/WW2/iron_cross_second_class,/obj/item/clothing/accessory/medal/WW2/iron_cross_second_class,/obj/item/clothing/accessory/medal/WW2/iron_cross_second_class,/obj/item/clothing/accessory/medal/WW2/iron_cross_second_class,/obj/item/clothing/accessory/medal/WW2/iron_cross_second_class,/obj/item/clothing/accessory/medal/WW2/iron_cross_second_class,/obj/item/clothing/accessory/medal/WW2/iron_cross_second_class,/obj/item/clothing/accessory/medal/WW2/iron_cross_second_class,/obj/item/clothing/accessory/medal/WW2/iron_cross_second_class,/obj/item/clothing/accessory/medal/WW2/iron_cross_second_class,/obj/item/clothing/accessory/medal/WW2/iron_cross_second_class,/obj/item/clothing/accessory/medal/WW2/iron_cross_second_class,/obj/item/clothing/accessory/medal/WW2/iron_cross_second_class,/obj/item/clothing/accessory/medal/WW2/iron_cross_second_class,/turf/floor/carpet,/area/prishtina/german/ss_armory)
"aO" = (/obj/structure/table/wood,/obj/item/clothing/accessory/medal/WW2/wound_badge_silver,/obj/item/clothing/accessory/medal/WW2/wound_badge_silver,/obj/item/clothing/accessory/medal/WW2/wound_badge_silver,/obj/item/clothing/accessory/medal/WW2/wound_badge_silver,/obj/item/clothing/accessory/medal/WW2/wound_badge_silver,/obj/item/clothing/accessory/medal/WW2/wound_badge_silver,/obj/item/clothing/accessory/medal/WW2/wound_badge_silver,/obj/item/clothing/accessory/medal/WW2/wound_badge_silver,/obj/item/clothing/accessory/medal/WW2/wound_badge_silver,/obj/item/clothing/accessory/medal/WW2/wound_badge_silver,/obj/item/clothing/accessory/medal/WW2/wound_badge_silver,/obj/item/clothing/accessory/medal/WW2/wound_badge_silver,/obj/item/clothing/accessory/medal/WW2/wound_badge_silver,/obj/item/clothing/accessory/medal/WW2/wound_badge_silver,/obj/item/clothing/accessory/medal/WW2/wound_badge_silver,/obj/item/clothing/accessory/medal/WW2/wound_badge_silver,/obj/item/clothing/accessory/medal/WW2/wound_badge_gold,/obj/item/clothing/accessory/medal/WW2/wound_badge_gold,/obj/item/clothing/accessory/medal/WW2/wound_badge_gold,/obj/item/clothing/accessory/medal/WW2/wound_badge_gold,/obj/item/clothing/accessory/medal/WW2/wound_badge_gold,/obj/item/clothing/accessory/medal/WW2/wound_badge_gold,/obj/item/clothing/accessory/medal/WW2/wound_badge_gold,/obj/item/clothing/accessory/medal/WW2/wound_badge_gold,/obj/item/clothing/accessory/medal/WW2/wound_badge_gold,/obj/item/clothing/accessory/medal/WW2/wound_badge_gold,/obj/item/clothing/accessory/medal/WW2/wound_badge_gold,/obj/item/clothing/accessory/medal/WW2/wound_badge_gold,/obj/item/clothing/accessory/medal/WW2/wound_badge_gold,/obj/item/clothing/accessory/medal/WW2/wound_badge_gold,/obj/item/clothing/accessory/medal/WW2/wound_badge_gold,/obj/item/clothing/accessory/medal/WW2/wound_badge_gold,/obj/item/clothing/accessory/medal/WW2/wound_badge_gold,/obj/item/clothing/accessory/medal/WW2/wound_badge_gold,/obj/item/clothing/accessory/medal/WW2/wound_badge_gold,/obj/item/clothing/accessory/medal/WW2/wound_badge_gold,/obj/item/clothing/accessory/medal/WW2/wound_badge_black,/obj/item/clothing/accessory/medal/WW2/wound_badge_black,/obj/item/clothing/accessory/medal/WW2/wound_badge_black,/obj/item/clothing/accessory/medal/WW2/wound_badge_black,/obj/item/clothing/accessory/medal/WW2/wound_badge_black,/obj/item/clothing/accessory/medal/WW2/wound_badge_black,/obj/item/clothing/accessory/medal/WW2/wound_badge_black,/obj/item/clothing/accessory/medal/WW2/wound_badge_black,/obj/item/clothing/accessory/medal/WW2/wound_badge_black,/obj/item/clothing/accessory/medal/WW2/wound_badge_black,/obj/item/clothing/accessory/medal/WW2/wound_badge_black,/obj/item/clothing/accessory/medal/WW2/wound_badge_black,/obj/item/clothing/accessory/medal/WW2/wound_badge_black,/obj/item/clothing/accessory/medal/WW2/wound_badge_black,/obj/item/clothing/accessory/medal/WW2/wound_badge_black,/obj/item/clothing/accessory/medal/WW2/tank_destruction_badge_silver,/obj/item/clothing/accessory/medal/WW2/tank_destruction_badge_silver,/obj/item/clothing/accessory/medal/WW2/tank_destruction_badge_silver,/obj/item/clothing/accessory/medal/WW2/tank_destruction_badge_silver,/obj/item/clothing/accessory/medal/WW2/tank_destruction_badge_silver,/obj/item/clothing/accessory/medal/WW2/tank_destruction_badge_silver,/obj/item/clothing/accessory/medal/WW2/tank_destruction_badge_silver,/obj/item/clothing/accessory/medal/WW2/tank_destruction_badge_silver,/obj/item/clothing/accessory/medal/WW2/tank_destruction_badge_silver,/obj/item/clothing/accessory/medal/WW2/tank_destruction_badge_silver,/obj/item/clothing/accessory/medal/WW2/tank_destruction_badge_silver,/obj/item/clothing/accessory/medal/WW2/tank_destruction_badge_silver,/obj/item/clothing/accessory/medal/WW2/tank_destruction_badge_silver,/obj/item/clothing/accessory/medal/WW2/tank_destruction_badge_gold,/obj/item/clothing/accessory/medal/WW2/tank_destruction_badge_gold,/obj/item/clothing/accessory/medal/WW2/tank_destruction_badge_gold,/obj/item/clothing/accessory/medal/WW2/tank_destruction_badge_gold,/obj/item/clothing/accessory/medal/WW2/tank_destruction_badge_gold,/obj/item/clothing/accessory/medal/WW2/tank_destruction_badge_gold,/obj/item/clothing/accessory/medal/WW2/tank_destruction_badge_gold,/obj/item/clothing/accessory/medal/WW2/tank_destruction_badge_gold,/obj/item/clothing/accessory/medal/WW2/tank_destruction_badge_gold,/obj/item/clothing/accessory/medal/WW2/tank_destruction_badge_gold,/obj/item/clothing/accessory/medal/WW2/tank_destruction_badge_gold,/obj/item/clothing/accessory/medal/WW2/tank_destruction_badge_gold,/obj/item/clothing/accessory/medal/WW2/tank_destruction_badge_gold,/turf/floor/carpet,/area/prishtina/german/ss_armory)
"aP" = (/obj/structure/simple_door/key_door/german/SS,/turf/floor/wood,/area/prishtina/german/ss_armory)
"aQ" = (/obj/structure/simple_door/key_door/german/command_intermediate{name = "SS Officer Quarters"},/turf/floor/carpet,/area/prishtina/german/ss_armory)
"aR" = (/obj/machinery/light/small,/turf/floor/carpet,/area/prishtina/german/ss_armory)
"aS" = (/obj/structure/bed/chair/comfy,/obj/machinery/light/small{dir = 1},/turf/floor/carpet,/area/prishtina/german/ss_armory)
"aT" = (/obj/structure/bed/chair/comfy,/turf/floor/carpet,/area/prishtina/german/ss_armory)
"aU" = (/obj/structure/table/wood,/obj/item/weapon/phone,/obj/machinery/light/small{dir = 1},/turf/floor/carpet,/area/prishtina/german/ss_armory)
"aV" = (/obj/structure/closet/cabinet,/turf/floor/carpet,/area/prishtina/german/ss_armory)
"aW" = (/obj/structure/window/classic,/obj/structure/curtain/open/privacy,/turf/floor/wood,/area/prishtina/german/ss_armory)
"aX" = (/obj/structure/simple_door/key_door/german/command_intermediate{name = "SS Officer Quarters"},/turf/floor/wood,/area/prishtina/german/ss_armory)
"aY" = (/obj/item/weapon/stool/padded,/obj/machinery/light/small,/turf/floor/carpet,/area/prishtina/german/ss_armory)
"aZ" = (/obj/structure/table/wood/poker,/turf/floor/carpet,/area/prishtina/german/ss_armory)
"ba" = (/obj/item/weapon/stool/padded,/turf/floor/carpet,/area/prishtina/german/ss_armory)
"bb" = (/obj/structure/bed/chair/comfy{dir = 4},/obj/machinery/light/small,/turf/floor/carpet,/area/prishtina/german/ss_armory)
"bc" = (/obj/structure/table/wood,/obj/item/weapon/reagent_containers/food/snacks/monkeykabob,/obj/item/weapon/reagent_containers/food/snacks/omelette,/obj/item/weapon/reagent_containers/food/snacks/sausage,/turf/floor/carpet,/area/prishtina/german/ss_armory)
"bd" = (/obj/structure/closet/freezer/meat,/turf/floor/carpet,/area/prishtina/german/ss_armory)
"be" = (/obj/structure/closet/freezer/fridge,/turf/floor/carpet,/area/prishtina/german/ss_armory)
"bf" = (/obj/structure/table/wood,/obj/item/weapon/reagent_containers/food/snacks/applepie,/obj/item/weapon/reagent_containers/food/snacks/applepie,/obj/item/weapon/material/knife/butch,/turf/floor/carpet,/area/prishtina/german/ss_armory)
"bg" = (/obj/structure/microwave/oven,/obj/machinery/light/small,/turf/floor/carpet,/area/prishtina/german/ss_armory)

(1,1,1) = {"
acacacacacacacacacacacacacacacacacacacac
ajamanaoanaoapadawaxayazaAazaBaBaCaDaEaj
ajahahahahahahadaBaFaBaBaAazaBaGaAaHaDaj
ajaoanaoanaoahadaBaBaBaIaAazaBaJaAaAaAaj
ajaKahahahahaKadaLaMaBaBaAazaBaIaAaNaOaj
aaababacabaPacacaAaAaAaQaAaAaAaQaAaRaBaj
adaeafagafahaiajaSaTaTaBaAaUaVaBaAaAaQaj
adahahahahahahaWaBaBaBaIaAaBaBaBaBaxaBaj
adahahahahahahaXaBaBaBaBaQaBaBaBaBaBaBaj
adaqauasaratavajaYaZbaaRaAbbbcbdbebfbgaj
aaacacacacacacacacacacacacacacacacacacac
"}
