"a" = (/turf/wall/stone,/area/prishtina/soviet/small_map/inside/prison)
"b" = (/obj/machinery/light/small{dir = 1},/turf/floor/plating/cobblestone/vertical/dark,/area/prishtina/soviet/small_map/inside/prison)
"c" = (/turf/floor/plating/cobblestone/vertical/dark,/area/prishtina/soviet/small_map/inside/prison)
"d" = (/obj/structure/simple_door/key_door/soviet/command_intermediate{name = "Prison Cell #4"},/turf/floor/plating/cobblestone/vertical/dark,/area/prishtina/soviet/small_map/inside/prison)
"e" = (/obj/structure/multiz/ladder/ww2/up{area_id = "soviet_prison"},/turf/floor/plating/cobblestone/vertical/dark,/area/prishtina/soviet/small_map/inside/prison)
"f" = (/obj/machinery/light/small,/turf/floor/plating/cobblestone/vertical/dark,/area/prishtina/soviet/small_map/inside/prison)
"g" = (/obj/structure/bed,/obj/structure/noose,/turf/floor/plating/cobblestone/vertical/dark,/area/prishtina/soviet/small_map/inside/prison)
"h" = (/obj/structure/simple_door/key_door/soviet/command_intermediate{name = "Prison Cell #1"},/turf/floor/plating/cobblestone/vertical/dark,/area/prishtina/soviet/small_map/inside/prison)
"i" = (/obj/structure/simple_door/key_door/soviet/command_intermediate{name = "Prison Cell #2"},/turf/floor/plating/cobblestone/vertical/dark,/area/prishtina/soviet/small_map/inside/prison)
"j" = (/obj/structure/simple_door/key_door/soviet/command_intermediate{name = "Prison Cell #3"},/turf/floor/plating/cobblestone/vertical/dark,/area/prishtina/soviet/small_map/inside/prison)

(1,1,1) = {"
aaaaaaaaaaa
abcacbcacba
agchcccicga
accacccacca
aaaacecaaaa
abcacccacba
agcjcccdcga
accacfcacca
aaaaaaaaaaa
"}
