"a" = (/turf/wall/stone,/area/prishtina/soviet/small_map/inside/kitchen/cellar)
"b" = (/obj/effect/floor_decal/industrial/outline/grey,/turf/floor/plating/cobblestone/vertical/dark,/area/prishtina/soviet/small_map/inside/kitchen/cellar)
"c" = (/turf/floor/plating/cobblestone/vertical/dark,/area/prishtina/soviet/small_map/inside/kitchen/cellar)
"d" = (/obj/machinery/light/small{dir = 1},/turf/floor/plating/cobblestone/vertical/dark,/area/prishtina/soviet/small_map/inside/kitchen/cellar)
"e" = (/obj/structure/multiz/ladder/ww2/up{area_id = "soviet_kitchen_cellar"},/turf/floor/plating/cobblestone/vertical/dark,/area/prishtina/soviet/small_map/inside/kitchen/cellar)

(1,1,1) = {"
aaaaaaa
abcdcba
abcccba
abcecba
abcccba
abcccba
aaaaaaa
"}
