"a" = (/turf/wall/stone,/area/prishtina/soviet/small_map/inside/medical/morgue)
"b" = (/turf/floor/plating/cobblestone/vertical/dark,/area/prishtina/soviet/small_map/inside/medical/morgue)
"c" = (/obj/machinery/light/small{dir = 1},/turf/floor/plating/cobblestone/vertical/dark,/area/prishtina/soviet/small_map/inside/medical/morgue)
"d" = (/obj/structure/multiz/ladder/ww2/up{area_id = "soviet_morgue"},/turf/floor/plating/cobblestone/vertical/dark,/area/prishtina/soviet/small_map/inside/medical/morgue)
"e" = (/obj/structure/closet/coffin/anchored,/turf/floor/plating/cobblestone/vertical/dark,/area/prishtina/soviet/small_map/inside/medical/morgue)
"f" = (/obj/machinery/light/small,/turf/floor/plating/cobblestone/vertical/dark,/area/prishtina/soviet/small_map/inside/medical/morgue)

(1,1,1) = {"
aaaaaaaaa
abbbcbbda
abebebeba
abebebeba
abebebeba
abebebeba
abebebeba
abebebeba
abbbfbbba
aaaaaaaaa
"}
