"aa" = (/obj/structure/grille{icon_state = "fence1-2"; name = "fence"},/turf/simulated/floor/plating/grass,/area/prishtina/german/outside)
"ab" = (/turf/simulated/floor/plating/grass,/area/prishtina/german/outside)
"ac" = (/turf/simulated/floor/plating/road,/area/prishtina/german/outside)
"ad" = (/obj/effect/floor_decal/corner_kafel/yellow/diagonal,/turf/simulated/floor/plating/road,/area/prishtina/german/outside)
"ae" = (/turf/simulated/floor/plating/asteroid,/area/prishtina/field)
"af" = (/turf/simulated/wall,/area/prishtina/german/outside)
"ag" = (/obj/effect/floor_decal/corner_oldtile/white,/turf/simulated/floor/plating/road,/area/prishtina/german/outside)
"ah" = (/obj/effect/decal/cleanable/dirt,/obj/structure/reagent_dispensers/fueltank,/obj/effect/decal/cleanable/cobweb,/turf/simulated/floor/plating/road,/area/prishtina/german/outside)
"ai" = (/obj/structure/table/rack,/turf/simulated/floor/plating/road,/area/prishtina/german/outside)
"aj" = (/obj/effect/decal/cleanable/dirt,/obj/structure/table/rack,/turf/simulated/floor/plating/road,/area/prishtina/german/outside)
"ak" = (/obj/machinery/light/small{dir = 1},/turf/simulated/floor/plating/road,/area/prishtina/german/outside)
"al" = (/obj/effect/decal/cleanable/dirt,/turf/simulated/floor/plating/road,/area/prishtina/german/outside)
"am" = (/obj/effect/floor_decal/industrial/warning/dust{dir = 4},/obj/structure/simple_door/key_door/anyone,/turf/simulated/floor/plating/road,/area/prishtina/german/outside)
"an" = (/obj/structure/sign/flag/germany{pixel_y = 30},/turf/simulated/floor/plating/road,/area/prishtina/german/outside)
"ao" = (/obj/effect/floor_decal/industrial/warning/dust{dir = 4},/obj/structure/grille{icon_state = "fence1-2"; name = "fence"},/turf/simulated/floor/plating/road,/area/prishtina/german/outside)
"ap" = (/obj/effect/floor_decal/industrial/warning/dust,/turf/simulated/floor/plating/road,/area/prishtina/german/outside)
"aq" = (/obj/effect/floor_decal/industrial/warning/dust,/obj/effect/decal/cleanable/dirt,/turf/simulated/floor/plating/road,/area/prishtina/german/outside)
"ar" = (/obj/effect/decal/cleanable/dirt,/obj/effect/decal/cleanable/liquid_fuel,/obj/machinery/light/small{dir = 8},/turf/simulated/floor/plating,/area/prishtina/german/outside)
"as" = (/obj/effect/decal/cleanable/dirt,/turf/simulated/floor/plating,/area/prishtina/german/outside)
"at" = (/obj/structure/multiz/stairs{dir = 8},/turf/simulated/floor/plating,/area/prishtina/german/outside)
"au" = (/obj/effect/floor_decal/industrial/warning/dust{dir = 1},/turf/simulated/floor/plating/road,/area/prishtina/german/outside)
"av" = (/obj/effect/floor_decal/industrial/warning/dust{dir = 1},/obj/effect/decal/cleanable/dirt,/turf/simulated/floor/plating/road,/area/prishtina/german/outside)
"aw" = (/turf/simulated/floor/plating/asteroid,/area/prishtina/german/outside)
"ax" = (/obj/structure/atmospherics_pipe_tank/nitrogen,/turf/simulated/floor/plating/road,/area/prishtina/german/outside)
"ay" = (/obj/machinery/light/small,/turf/simulated/floor/plating/road,/area/prishtina/german/outside)
"az" = (/obj/structure/flora/ausbushes/fullgrass,/turf/simulated/floor/plating/grass,/area/prishtina/german/outside)
"aA" = (/obj/structure/flora/ausbushes/sunnybush,/turf/simulated/floor/plating/grass,/area/prishtina/german/outside)
"aB" = (/obj/effect/decal/cleanable/dirt,/obj/structure/reagent_dispensers/fueltank,/turf/simulated/floor/plating/road,/area/prishtina/german/outside)
"aC" = (/obj/structure/table/rack,/obj/item/weapon/tape_roll,/obj/item/weapon/tape_roll,/turf/simulated/floor/plating/road,/area/prishtina/german/outside)
"aD" = (/obj/effect/decal/cleanable/dirt,/obj/structure/table/rack,/obj/item/weapon/weldingtool,/turf/simulated/floor/plating/road,/area/prishtina/german/outside)
"aE" = (/obj/structure/table/rack,/obj/item/weapon/wirecutters,/turf/simulated/floor/plating/road,/area/prishtina/german/outside)
"aF" = (/obj/effect/floor_decal/industrial/warning/dust{dir = 4},/obj/effect/decal/cleanable/blood/oil,/turf/simulated/floor/plating/road,/area/prishtina/german/outside)
"aG" = (/obj/structure/sign/flag/germany{pixel_x = 0; pixel_y = 30},/turf/simulated/floor/plating/road,/area/prishtina/german/outside)
"aH" = (/obj/effect/decal/cleanable/ash,/turf/simulated/floor/plating/road,/area/prishtina/german/outside)
"aI" = (/obj/effect/floor_decal/industrial/warning/dust{dir = 4},/turf/simulated/floor/plating/road,/area/prishtina/german/outside)
"aJ" = (/obj/effect/decal/cleanable/blood/oil,/obj/effect/decal/cleanable/dirt,/turf/simulated/floor/plating,/area/prishtina/german/outside)
"aK" = (/obj/effect/decal/cleanable/dirt,/obj/item/weapon/wrench,/turf/simulated/floor/plating,/area/prishtina/german/outside)
"aL" = (/obj/effect/decal/cleanable/dirt,/obj/effect/floor_decal/rust,/turf/simulated/floor/plating,/area/prishtina/german/outside)
"aM" = (/obj/effect/floor_decal/industrial/warning/dust{dir = 1},/obj/effect/decal/cleanable/ash,/turf/simulated/floor/plating/road,/area/prishtina/german/outside)
"aN" = (/obj/effect/floor_decal/industrial/warning/dust{dir = 4},/obj/effect/decal/cleanable/dirt,/turf/simulated/floor/plating/road,/area/prishtina/german/outside)
"aO" = (/obj/effect/decal/cleanable/liquid_fuel,/turf/simulated/floor/plating/road,/area/prishtina/german/outside)
"aP" = (/obj/effect/decal/cleanable/blood/oil,/turf/simulated/floor/plating/road,/area/prishtina/german/outside)
"aQ" = (/obj/structure/girder,/turf/simulated/floor/plating/road,/area/prishtina/german/outside)
"aR" = (/obj/structure/flora/ausbushes/fullgrass,/obj/structure/flora/ausbushes/fullgrass,/turf/simulated/floor/plating/grass,/area/prishtina/german/outside)
"aS" = (/obj/structure/simple_door/key_door/anyone,/turf/simulated/floor/plating/road,/area/prishtina/german/outside)
"aT" = (/obj/structure/window/sandbag{tag = "icon-sandbag (WEST)"; icon_state = "sandbag"; dir = 8},/obj/structure/window/sandbag{tag = "icon-sandbag (NORTH)"; icon_state = "sandbag"; dir = 1},/turf/simulated/floor/plating/asteroid,/area/prishtina/german/outside)
"aU" = (/obj/structure/window/sandbag{tag = "icon-sandbag (NORTH)"; icon_state = "sandbag"; dir = 1},/turf/simulated/floor/plating/asteroid,/area/prishtina/german/outside)
"aV" = (/obj/structure/window/sandbag{tag = "icon-sandbag (EAST)"; icon_state = "sandbag"; dir = 4},/obj/structure/window/sandbag{tag = "icon-sandbag (NORTH)"; icon_state = "sandbag"; dir = 1},/turf/simulated/floor/plating/asteroid,/area/prishtina/german/outside)
"aW" = (/obj/structure/window/sandbag{tag = "icon-sandbag (WEST)"; icon_state = "sandbag"; dir = 8},/turf/simulated/floor/plating/asteroid,/area/prishtina/german/outside)
"aX" = (/obj/effect/floor_decal/industrial/warning/dust,/turf/simulated/floor/plating/asteroid,/area/prishtina/german/outside)
"aY" = (/obj/structure/window/sandbag{tag = "icon-sandbag (EAST)"; icon_state = "sandbag"; dir = 4},/turf/simulated/floor/plating/asteroid,/area/prishtina/german/outside)
"aZ" = (/obj/effect/floor_decal/industrial/warning/dust{dir = 4},/turf/simulated/floor/plating/asteroid,/area/prishtina/german/outside)
"ba" = (/obj/item/weapon/gun/projectile/minigun/maximstat,/turf/simulated/floor/plating/asteroid,/area/prishtina/german/outside)
"bb" = (/obj/effect/floor_decal/industrial/warning/dust{dir = 8},/turf/simulated/floor/plating/asteroid,/area/prishtina/german/outside)
"bc" = (/obj/effect/floor_decal/industrial/warning/dust{dir = 1},/turf/simulated/floor/plating/asteroid,/area/prishtina/german/outside)
"bd" = (/obj/structure/window/sandbag{step_y = 0},/obj/structure/window/sandbag{tag = "icon-sandbag (WEST)"; icon_state = "sandbag"; dir = 8},/turf/simulated/floor/plating/asteroid,/area/prishtina/german/outside)
"be" = (/obj/structure/window/sandbag{step_y = 0},/turf/simulated/floor/plating/asteroid,/area/prishtina/german/outside)
"bf" = (/obj/structure/window/sandbag{tag = "icon-sandbag (EAST)"; icon_state = "sandbag"; dir = 4},/obj/structure/window/sandbag{step_y = 0},/turf/simulated/floor/plating/asteroid,/area/prishtina/german/outside)
"bg" = (/obj/structure/flora/ausbushes/sparsegrass,/turf/simulated/floor/plating/grass,/area/prishtina/german/outside)

(1,1,1) = {"
aaababababababababababacacacacacacacacacacacacacacacacacacadacacacacacaeaeaeaeaeaeaeaeaeaeaeaeaeaeae
aaabafafafafafafafafabacacacacagagagagagagagagagagagagagagadacacacacacaeaeaeaeaeaeaeaeaeaeaeaeaeaeae
aaafafahaiajaiakalamacacacacacagacacacacacacacacacacacacacadacacacacacaeaeaeaeaeaeaeaeaeaeaeaeaeaeae
aaafanalacacacacacaoacacacacacagacacacacacacacacacapapapapadapapapapacaeaeaeaeaeaeaeaeaeaeaeaeaeaeae
aaafapaqapapaqapapaoacacacacacagacacacacabababababapapapapadapapapapabaeaeaeaeaeaeaeaeaeaeaeaeaeaeae
aaafarasasasasasataoagagagagagagacacacacabababababacacacacadacacacacabaeaeaeaeaeaeaeaeaeaeaeaeaeaeae
aaafauauauavauauauaoacacacacacagacacacacabawawawabacacacacadacacacacabaeaeaeaeaeaeaeaeaeaeaeaeaeaeae
aaafacacacacalacalaoacacacacacagacacacacabawawawabacacacacadacacacacabaeaeaeaeaeaeaeaeaeaeaeaeaeaeae
aaafafaxalacacayacaoacacacacacagacacacacabawawawabacacacacadacacacacabaeaeaeaeaeaeaeaeaeaeaeaeaeaeae
aaabafafafafafafafafabacacacacagacacacacabawawawabacacacacadacacacacabaeaeaeaeaeaeaeaeaeaeaeaeaeaeae
aaazabababababazazababacacacacagacacacacabababababacacacacadacacacacabaeaeaeaeaeaeaeaeaeaeaeaeaeaeae
aaabababazaAabazabababacacacacagacacacacabababazabacacacacadacacacacabaeaeaeaeaeaeaeaeaeaeaeaeaeaeae
aaabazababababababababacacacacagacacacacabababababacacacacadacacacacabaeaeaeaeaeaeaeaeaeaeaeaeaeaeae
aaababababababababababacacacacagacacacacabazabababacacacacadacacacacabaeaeaeaeaeaeaeaeaeaeaeaeaeaeae
aaabafafafafafafafafabacacacacagacacacacabababababacacacacadacacacacabaeaeaeaeaeaeaeaeaeaeaeaeaeaeae
aaafafaBaCaDaEakacaFacacacacacagacacacacababazababacacacacadacacacacabaeaeaeaeaeaeaeaeaeaeaeaeaeaeae
aaafaGacaHacacacalaIacacacacacagacacacacabababababacacacacadacacacacabaeaeaeaeaeaeaeaeaeaeaeaeaeaeae
aaafapapapapaqapapaIacacacacacagacacacacabababababacacacacadacacacacabaeaeaeaeaeaeaeaeaeaeaeaeaeaeae
aaafarasaJasaKaLataIagagagagagagacacacacabababazabacacacacadacacacacabaeaeaeaeaeaeaeaeaeaeaeaeaeaeae
aaafauauauauauaMauaNacacacacacagacacacacabababababacacacacadacacacacabaeaeaeaeaeaeaeaeaeaeaeaeaeaeae
aaafacalaOacalaPacaIacacacacacagacacacacabababababacacacacadacacacacabaeaeaeaeaeaeaeaeaeaeaeaeaeaeae
aaafafaxacacacayalaIacacacacacagacacacacabababababacacacacadacacacacabaeaeaeaeaeaeaeaeaeaeaeaeaeaeae
aaabafafafafafafafafaQacacacacagacacacacababababazacacacacadacacacacabaeaeaeaeaeaeaeaeaeaeaeaeaeaeae
aaabababababababababaaacacacacagacacacacabazabababacacacacadacacacacabaeaeaeaeaeaeaeaeaeaeaeaeaeaeae
aaabababababababababaaacacacacagacacacacabababababacacacacadacacacacabaeaeaeaeaeaeaeaeaeaeaeaeaeaeae
aaababazabababazaRabaaacacacacagacacacacabababababacacacacadacacacacabaeaeaeaeaeaeaeaeaeaeaeaeaeaeae
aaababababababazazabaaacacacacagacacacacabababababacacacacadacacacacabaeaeaeaeaeaeaeaeaeaeaeaeaeaeae
aaabababababababababaaacacacacagacacacacababazababacacacacadacacacacabaeaeaeaeaeaeaeaeaeaeaeaeaeaeae
aaabababababababababaaacacacacagacacacacabababababacacacacadacacacacabaeaeaeaeaeaeaeaeaeaeaeaeaeaeae
aaabababababazabababaSacacacacacacacacacabababababacacacacadacacacacabaeaeaeaeaeaeaeaeaeaeaeaeaeaeae
aaabababababababababababababababababababababazababacacacacadacacacacabaeaeaeaeaeaeaeaeaeaeaeaeaeaeae
aaababababababababababababababababababababababababacacacacadacacacacabaeaeaeaeaeaeaeaeaeaeaeaeaeaeae
aaababaRabababababababazabababababababazabababababacacacacadacacacacabaeaeaeaeaeaeaeaeaeaeaeaeaeaeae
aaababaRazabababababababababababababababababazababacacacacadacacacacabaeaeaeaeaeaeaeaeaeaeaeaeaeaeae
aaababababababababababababababababababababababababacacacacadacacacacabaeaeaeaeaeaeaeaeaeaeaeaeaeaeae
aaababababababababababababababababababababababababacacacacadacacacacabaeaeaeaeaeaeaeaeaeaeaeaeaeaeae
aaababababababaTaUawaUaVababababazababababababababacacacacadacacacacabaeaeaeaeaeaeaeaeaeaeaeaeaeaeae
aaababababababaWawaXawaYabababababababababababababacacacacadacacacacabaeaeaeaeaeaeaeaeaeaeaeaeaeaeae
aaababazabababaWaZbabbaYababababazababababababababacacacacadacacacacabaeaeaeaeaeaeaeaeaeaeaeaeaeaeae
aaababababababaWawbcawaYababababababababazababazabacacacacadacacacacabaeaeaeaeaeaeaeaeaeaeaeaeaeaeae
aaababababababbdbebebebfabababababababababababababacacacacadacacacacabaeaeaeaeaeaeaeaeaeaeaeaeaeaeae
aaababababababababababababababbgbgababababababababacacacacadacacacacabaeaeaeaeaeaeaeaeaeaeaeaeaeaeae
aaabbgabazabababababbgbgababababababababababazababacacacacadacacacacabaeaeaeaeaeaeaeaeaeaeaeaeaeaeae
aaabababababababababbgbgabababababababababababababacacacacadacacacacabaeaeaeaeaeaeaeaeaeaeaeaeaeaeae
aaababababababababababababbgabababababababababababacacacacadacacacacabaeaeaeaeaeaeaeaeaeaeaeaeaeaeae
aaababababbgabazabababababababababbgabababazabababapapapapadapapapapabaeaeaeaeaeaeaeaeaeaeaeaeaeaeae
aaabazabbgababababababbgabababababbgabababababababapapapapadapapapapabaeaeaeaeaeaeaeaeaeaeaeaeaeaeae
aaababababababababababababababababababababababababacacacacadacacacacabaeaeaeaeaeaeaeaeaeaeaeaeaeaeae
aaabababababababababababababazababababababababababababababababababababaeaeaeaeaeaeaeaeaeaeaeaeaeaeae
aeaeaeaeaeaeaeaeaeaeaeaeaeaeaeaeaeaeaeaeaeaeaeaeaeaeaeaeaeaeaeaeaeaeaeaeaeaeaeaeaeaeaeaeaeaeaeaeaeae
"}
