"aa" = (/obj/skybox,/turf/wall/indestructable/black,/area/prishtina/void)
"ab" = (/turf/wall/indestructable/black,/area/prishtina/void)
"ae" = (/turf/wall/brick,/area/prishtina/void)
"ch" = (/turf/wall/indestructable/black,/area/prishtina/void/civilian_basements{base_turf = /turf/floor/dirt; name = "Basement"})
"ci" = (/turf/wall/brick,/area/prishtina/void/civilian_basements{base_turf = /turf/floor/dirt; name = "Basement"})
"cj" = (/obj/item/stack/material/wood,/obj/effect/decal/cleanable/cobweb,/turf/floor/wood,/area/prishtina/void/civilian_basements{base_turf = /turf/floor/dirt; name = "Basement"})
"ck" = (/turf/floor/wood,/area/prishtina/void/civilian_basements{base_turf = /turf/floor/dirt; name = "Basement"})
"cl" = (/obj/structure/bookcase,/turf/floor/wood,/area/prishtina/void/civilian_basements{base_turf = /turf/floor/dirt; name = "Basement"})
"cm" = (/turf/floor/wood_broken,/area/prishtina/void/civilian_basements{base_turf = /turf/floor/dirt; name = "Basement"})
"cn" = (/obj/item/weapon/book/manual/detective,/turf/floor/wood,/area/prishtina/void/civilian_basements{base_turf = /turf/floor/dirt; name = "Basement"})
"co" = (/obj/item/stack/material/wood,/turf/floor/wood,/area/prishtina/void/civilian_basements{base_turf = /turf/floor/dirt; name = "Basement"})
"cp" = (/obj/structure/bookcase{name = "bookcase (Fiction)"},/turf/floor/wood,/area/prishtina/void/civilian_basements{base_turf = /turf/floor/dirt; name = "Basement"})
"cq" = (/obj/item/weapon/book,/turf/floor/wood,/area/prishtina/void/civilian_basements{base_turf = /turf/floor/dirt; name = "Basement"})
"cr" = (/obj/effect/decal/cleanable/cobweb2,/turf/floor/wood,/area/prishtina/void/civilian_basements{base_turf = /turf/floor/dirt; name = "Basement"})
"cs" = (/mob/living/simple_animal/mouse,/turf/floor/wood,/area/prishtina/void/civilian_basements{base_turf = /turf/floor/dirt; name = "Basement"})
"ct" = (/obj/item/weapon/paper/crumpled,/turf/floor/wood,/area/prishtina/void/civilian_basements{base_turf = /turf/floor/dirt; name = "Basement"})
"cu" = (/obj/structure/bookcase{name = "bookcase (Socialist)"},/turf/floor/wood,/area/prishtina/void/civilian_basements{base_turf = /turf/floor/dirt; name = "Basement"})
"cv" = (/obj/item/stack/material/wood,/obj/effect/decal/cleanable/ash,/turf/floor/wood,/area/prishtina/void/civilian_basements{base_turf = /turf/floor/dirt; name = "Basement"})
"cw" = (/obj/item/weapon/paper,/turf/floor/wood,/area/prishtina/void/civilian_basements{base_turf = /turf/floor/dirt; name = "Basement"})
"cx" = (/obj/item/weapon/paper/crumpled/bloody,/turf/floor/wood,/area/prishtina/void/civilian_basements{base_turf = /turf/floor/dirt; name = "Basement"})
"cy" = (/obj/item/weapon/book/convention,/turf/floor/wood,/area/prishtina/void/civilian_basements{base_turf = /turf/floor/dirt; name = "Basement"})
"cz" = (/obj/item/weapon/book/manual/chef_recipes,/turf/floor/wood,/area/prishtina/void/civilian_basements{base_turf = /turf/floor/dirt; name = "Basement"})
"cA" = (/obj/structure/multiz/ladder/ww2{area_id = "basement"},/turf/floor/wood,/area/prishtina/void/civilian_basements{base_turf = /turf/floor/dirt; name = "Basement"})
"cB" = (/obj/item/weapon/doctor_handbook,/turf/floor/wood,/area/prishtina/void/civilian_basements{base_turf = /turf/floor/dirt; name = "Basement"})
"cC" = (/obj/effect/decal/cleanable/ash,/obj/item/flashlight/flare/nighttime,/turf/floor/wood,/area/prishtina/void/civilian_basements{base_turf = /turf/floor/dirt; name = "Basement"})
"cD" = (/obj/item/weapon/paper,/obj/item/weapon/paper,/turf/floor/wood_broken,/area/prishtina/void/civilian_basements{base_turf = /turf/floor/dirt; name = "Basement"})
"cE" = (/obj/structure/multiz/ladder/ww2/up{area_id = "floor0"},/turf/floor/wood,/area/prishtina/void/civilian_basements{base_turf = /turf/floor/dirt; name = "Basement"})
"cH" = (/obj/item/weapon/broken_bottle,/turf/floor/wood,/area/prishtina/void/civilian_basements{base_turf = /turf/floor/dirt; name = "Basement"})
"cI" = (/obj/item/weapon/pen,/turf/floor/wood,/area/prishtina/void/civilian_basements{base_turf = /turf/floor/dirt; name = "Basement"})
"cJ" = (/obj/item/weapon/cigbutt,/turf/floor/wood,/area/prishtina/void/civilian_basements{base_turf = /turf/floor/dirt; name = "Basement"})
"cK" = (/obj/effect/decal/cleanable/ash,/turf/floor/wood,/area/prishtina/void/civilian_basements{base_turf = /turf/floor/dirt; name = "Basement"})
"cL" = (/obj/item/flashlight/flare/nighttime,/turf/floor/wood,/area/prishtina/void/civilian_basements{base_turf = /turf/floor/dirt; name = "Basement"})
"cM" = (/obj/item/weapon/paper,/obj/structure/bookcase,/turf/floor/wood,/area/prishtina/void/civilian_basements{base_turf = /turf/floor/dirt; name = "Basement"})
"cN" = (/obj/item/weapon/paper,/obj/item/weapon/paper,/turf/floor/wood,/area/prishtina/void/civilian_basements{base_turf = /turf/floor/dirt; name = "Basement"})
"cO" = (/obj/item/weapon/book/manual/barman_recipes,/turf/floor/wood,/area/prishtina/void/civilian_basements{base_turf = /turf/floor/dirt; name = "Basement"})
"cP" = (/obj/item/weapon/paper_bundle,/turf/floor/wood,/area/prishtina/void/civilian_basements{base_turf = /turf/floor/dirt; name = "Basement"})
"cQ" = (/obj/item/weapon/book/manual/medical_diagnostics_manual,/turf/floor/wood,/area/prishtina/void/civilian_basements{base_turf = /turf/floor/dirt; name = "Basement"})

(1,1,1) = {"
aaaaaaaaaaaaaaaaaaaaaaaaaaaaaaaaaaaaaaaaaaaaaaaaaaaaaaaaaaaaaaaaaaaaaaaaaaaaaaaaaaaaaaaaaaaaaaaaaaaaaaaaaaaaaaaaaaaaaaaa
aaaaaaaaaaaaaaaaaaaaaaaaaaaaaaaaaaaaaaaaaaaaaaaaaaaaaaaaaaaaaaaaaaaaaaaaaaaaaaaaaaaaaaaaaaaaaaaaaaaaaaaaaaaaaaaaaaaaaaaa
abababababababababababababababababababababababababababababababababababababababababababababababababababababababababababab
abababababababababababababababababababababababababababababababababababababababababababababababababababababababababababab
abababababababababababababababababababababababababababababababababababababababababababababababababababababababababababab
abababababababababababababababababababababababababababababababababababababababababababababababababababababababababababab
aaaaaaaachchchchchchchchchchchchchchchchchchchchchchchabababababababababababababaaaaaaaaaaaaaaaaaaaaaaaaaaaaaaaaaaaaaaaa
aaaaaaaachcicicicicicicicicicicicicicicicicicicicicichabababababababababababababaaaaaaaaaaaaaaaaaaaaaaaaaaaaaaaaaaaaaaaa
aaaaaaaachcicjckclckclckcmckcncocockcpcpckckcqckcrcichababababababababababababababababababababababababababababababababab
aaaaaaaachcickckcsckckckctckcucucpckcsckcvcuckckckcichababababababababaaabababababababababababababababababababababababab
aaaaaaaachcickckckckcpckckcwckckckcqcmcxcsckcmclckcichababababababababaaabababababababababababababababababababababababab
aaaaaaaachcickclckcqckcocycpczcuckckcuckckcpckckckcichabababababaeababababababababababababababababababababababababababab
aaaaaaaachcicAckckckcpckcmcpcBcpckcCcpcmckcucDckcEcichababababaeaeababababababababababababababababababababababababababab
aaaaaaaachcicAckcmcHcuctcscpckcpcmcscucIckcpckcocEcichabaeaeababaeababababababababababababababababababababababababababab
aaaaaaaachcicAckcmckcpckcmcpcmcuckcqcuckcmcuckckcEcichabababababaeababababababababababababababababababababababababababab
aaaaaaaachcickcIckcJcpcqcKcLcxclclckckcqcmckckcqckcichababababaeaeaeabababababababababababababababababababababababababab
aaaaaaaachcickckclckclckcpcpckcpckckcucocKcucxcmckcichabababababababababababaaaaabababababababababababababababababababab
aaaaaaaachcicMckclckckclckcpckcucmcwckckcNclcsclcmcichabababababababababababaaaaabababababababababababababababababababab
aaaaaaaachcicjcOcoctckcPckcmcqcocqckcpcpcBclcKcQcqcichabababababababababababaaaaabababababababababababababababababababab
aaaaaaaachcicicicicicicicicicicicicicicicicicicicicichababaaaaaaaaaaaaaaaaaaaaaaaaaaaaaaaaaaaaaaaaaaaaababababababababab
aaaaaaaachchchchchchchchchchchchchchchchchchchchchchchaaaaaaaaaaaaaaaaaaaaaaaaaaaaaaaaaaaaaaaaaaaaaaaaababababababababab
aaaaaaaaaaaaaaaaaaaaaaaaaaaaaaaaaaaaaaaaaaaaaaaaaaaaaaaaaaababababababababababababababababababababababababababababababab
aaaaaaaaaaaaaaaaaaaaaaaaaaaaaaaaaaaaaaaaaaaaaaaaaaaaaaaaaaababababababababababababababababababababababaaaaaaaaaaaaaaaaaa
aaaaaaaaaaaaaaaaaaaaaaaaaaaaaaaaaaaaaaaaaaaaabababababababababababababababababababababababababababababaaaaaaaaaaaaaaaaaa
abababababababababababababababababababababababababababababababababababababababababababababababababababaaaaaaaaaaaaaaaaaa
"}
