"a" = (/turf/wall/rockwall,/area/prishtina/german/bunker)
"b" = (/obj/structure/closet/crate/sandbags,/obj/machinery/light{dir = 1},/turf/floor/wood,/area/prishtina/german/bunker)
"c" = (/obj/structure/closet/crate/sandbags,/turf/floor/wood,/area/prishtina/german/bunker)
"d" = (/turf/floor/wood,/area/prishtina/german/bunker)
"e" = (/obj/machinery/vending/SSequipment,/obj/machinery/light{dir = 8},/turf/floor/wood,/area/prishtina/german/bunker)
"f" = (/obj/item/weapon/gun/projectile/automatic/mg34,/obj/item/ammo_magazine/a762,/obj/item/ammo_magazine/a762,/obj/item/ammo_magazine/a762,/obj/item/ammo_magazine/a762,/obj/item/ammo_magazine/a762,/obj/item/ammo_magazine/a762,/obj/item/ammo_magazine/a762,/obj/item/ammo_magazine/a762,/obj/structure/closet,/turf/floor/wood,/area/prishtina/german/bunker)
"g" = (/obj/structure/table/rack,/obj/item/weapon/grenade/explosive/stgnade,/obj/item/weapon/grenade/explosive/stgnade,/obj/item/weapon/grenade/explosive/stgnade,/obj/item/weapon/grenade/explosive/stgnade,/obj/item/weapon/grenade/explosive/stgnade,/obj/item/device/mine/betty,/obj/item/device/mine/betty,/obj/item/device/mine/betty,/obj/item/weapon/grenade/smokebomb/german,/obj/item/weapon/grenade/smokebomb/german,/obj/item/weapon/grenade/smokebomb/german,/obj/machinery/light{dir = 4},/turf/floor/wood,/area/prishtina/german/bunker)
"h" = (/obj/machinery/vending/SSequipment,/turf/floor/wood,/area/prishtina/german/bunker)
"i" = (/obj/structure/table/rack,/obj/item/weapon/grenade/explosive/stgnade,/obj/item/weapon/grenade/explosive/stgnade,/obj/item/weapon/grenade/explosive/stgnade,/obj/item/weapon/grenade/explosive/stgnade,/obj/item/weapon/grenade/explosive/stgnade,/obj/item/device/mine/betty,/obj/item/device/mine/betty,/obj/item/device/mine/betty,/obj/item/weapon/grenade/smokebomb/german,/obj/item/weapon/grenade/smokebomb/german,/obj/item/weapon/grenade/smokebomb/german,/turf/floor/wood,/area/prishtina/german/bunker)
"j" = (/obj/item/weapon/gun/projectile/pistol/luger,/obj/item/ammo_magazine/luger,/obj/structure/closet,/obj/item/ammo_magazine/luger,/obj/item/ammo_magazine/luger,/obj/item/ammo_magazine/luger,/obj/item/ammo_magazine/luger,/obj/item/ammo_magazine/luger,/obj/item/ammo_magazine/luger,/obj/item/ammo_magazine/luger,/turf/floor/wood,/area/prishtina/german/bunker)
"k" = (/obj/item/weapon/storage/backpack/flammenwerfer,/obj/structure/table/rack,/obj/item/weapon/flammenwerfer_fueltank,/obj/item/weapon/flammenwerfer_fueltank,/obj/item/weapon/flammenwerfer_fueltank,/turf/floor/wood,/area/prishtina/german/bunker)
"l" = (/obj/machinery/light{dir = 8},/turf/floor/wood,/area/prishtina/german/bunker)
"m" = (/obj/machinery/vending/germanapparel,/turf/floor/wood,/area/prishtina/german/bunker)
"n" = (/obj/structure/closet/crate/german_smoke_grenade,/obj/item/weapon/handcuffs,/obj/item/weapon/storage/belt/security/tactical,/obj/item/weapon/storage/backpack/german,/obj/item/weapon/melee/classic_baton,/turf/floor/wood,/area/prishtina/german/bunker)
"o" = (/obj/item/weapon/gun/projectile/boltaction/kar98k,/obj/item/weapon/attachment/scope/adjustable/sniper_scope,/obj/item/ammo_magazine/kar98k,/obj/item/ammo_magazine/kar98k,/obj/item/ammo_magazine/kar98k,/obj/item/ammo_magazine/kar98k,/obj/item/clothing/accessory/storage/webbing,/obj/item/ammo_magazine/kar98k,/obj/item/ammo_magazine/kar98k,/obj/item/ammo_magazine/kar98k,/obj/item/ammo_magazine/kar98k,/obj/structure/closet,/turf/floor/wood,/area/prishtina/german/bunker)
"p" = (/obj/effect/landmark{name = "JoinLateSS-Officer"},/turf/floor/wood,/area/prishtina/german/bunker)
"q" = (/obj/item/clothing/accessory/storage/webbing,/obj/item/weapon/gun/projectile/automatic/mp40,/obj/item/ammo_magazine/mp40,/obj/item/ammo_magazine/mp40,/obj/structure/closet,/obj/item/ammo_magazine/mp40,/obj/item/ammo_magazine/mp40,/obj/item/ammo_magazine/mp40,/obj/item/ammo_magazine/mp40,/obj/item/ammo_magazine/mp40,/obj/item/ammo_magazine/mp40,/obj/item/weapon/gun/projectile/automatic/mp40,/turf/floor/wood,/area/prishtina/german/bunker)
"r" = (/obj/effect/landmark{name = "JoinLateSS"},/turf/floor/wood,/area/prishtina/german/bunker)
"s" = (/obj/machinery/light{dir = 4},/turf/floor/wood,/area/prishtina/german/bunker)
"t" = (/obj/lift_lever/soviet,/turf/floor/wood,/area/prishtina/german/bunker)
"u" = (/obj/structure/railing{dir = 4},/turf/floor/wood,/area/prishtina/no_mans_land/invisible_wall)
"v" = (/turf/open,/area/prishtina/german/lift/down)
"w" = (/obj/structure/railing{dir = 8},/turf/floor/wood,/area/prishtina/no_mans_land/invisible_wall)
"x" = (/obj/lift_controller/down/soviet,/turf/open,/area/prishtina/german/lift/down)
"y" = (/obj/structure/railing{dir = 4},/obj/structure/railing{dir = 4},/turf/floor/wood,/area/prishtina/no_mans_land/invisible_wall)
"z" = (/obj/structure/railing{tag = "icon-railing0 (NORTH)"; icon_state = "railing0"; dir = 1},/turf/floor/wood,/area/prishtina/no_mans_land/invisible_wall)
"A" = (/obj/machinery/light,/turf/floor/wood,/area/prishtina/german/bunker)
"B" = (/obj/effect/landmark{name = "JoinLateSS"},/obj/machinery/light,/turf/floor/wood,/area/prishtina/german/bunker)
"C" = (/obj/map_metadata/pillarmap,/turf/wall/rockwall,/area/prishtina/german/bunker)
"D" = (/turf/floor/wood,/area/prishtina/no_mans_land/invisible_wall)
"E" = (/obj/structure/closet/crate/medical,/turf/floor/wood,/area/prishtina/german/bunker)
"F" = (/obj/structure/closet/crate/rations/german_liquids,/turf/floor/wood,/area/prishtina/german/bunker)
"G" = (/obj/structure/closet/crate/rations/german_alcohol,/turf/floor/wood,/area/prishtina/german/bunker)
"H" = (/obj/machinery/light{dir = 1},/obj/structure/closet/crate/rations/water,/turf/floor/wood,/area/prishtina/german/bunker)
"I" = (/obj/structure/closet/crate/rations/water,/turf/floor/wood,/area/prishtina/german/bunker)

(1,1,1) = {"
aaaaaaaaaaaaaaaaaaaaaaaaaaaaaaaaaaaaaaaaaaaaaaaaaaaaaaaaaaaaaaaaaaaaaa
aaaaaaaaaaaaaaaaaaaaaaaaaaaaaaaaaaaaaaaaaaaaaaaaaaaaaaaaaaaaaaaaaaaaaa
aaaaaaaaaaaaaaaaaaaaaaaaaaaaaaaaaaaaaaaaaaaaaaaaaaaaaaaaaaaaaaaaaaaaaa
aaaaaaaaaaaaaaaaaaaaaaaaaaaaaaaaaaaaaaaaaaaaaaaaaaaaaaaaaaaaaaaaaaaaaa
aaaaaaaaaaaaaaaaaaaaaaaaaaaaaaaaaaaaaaaaaaaaaaaaaaaaaaaaaaaaaaaaaaaaaa
aaaaaaaaaaaaaaaaaaaaaaaaaaaaaaaaaaaaaaaaaaaaaaaaaaaaaaaaaaaaaaaaaaaaaa
aaaaaaaaaaaaaaaaaaaaaaaaaaaaaaaaaaaaaaaaaaaaaaaaaaaaaaaaaaaaaaaaaaaaaa
aaaaaaaaaaaaaaaaaaaaaaaaaHIFFFGcccbccEEEEccbaaaaaaaaaaaaaaaaaaaaaaaaaa
aaaaaaaaaaaaaaaaaaaaaaaaadddddddddddddddddddaaaaaaaaaaaaaaaaaaaaaaaaaa
aaaaaaaaaaaaaaaaaaaaaaaaaedddffffffffffddddgaaaaaaaaaaaaaaaaaaaaaaaaaa
aaaaaaaaaaaaaaaaaaaaaaaaahdddddddddddddddddiaaaaaaaaaaaaaaaaaaaaaaaaaa
aaaaaaaaaaaaaaaaaaaaaaaaahdddddddddddddddddiaaaaaaaaaaaaaaaaaaaaaaaaaa
aaaaaaaaaaaaaaaaaaaaaaaaahdddjjjjjjjjjjddddiaaaaaaaaaaaaaaaaaaaaaaaaaa
aaaaaaaaaaaaaaaaaaaaaaaaahdddddddddddddddddiaaaaaaaaaaaaaaaaaaaaaaaaaa
aaaaaaaaaaaaaaaaaaaaaaaaahdddddddddddddddddiaaaaaaaaaaaaaaaaaaaaaaaaaa
aaaaaaaaaaaaaaaaaaaaaaaaahdddkkkkkkkkkkddddgaaaaaaaaaaaaaaaaaaaaaaaaaa
aaaaaaaaaaaaaaaaaaaaaaaaaldddddddddddddddddgaaaaaaaaaaaaaaaaaaaaaaaaaa
aaaaaaaaaaaaaaaaaaaaaaaaaldddddddddddddddddiaaaaaaaaaaaaaaaaaaaaaaaaaa
aaaaaaaaaaaaaaaaaaaaaaaaamdddnnnnnnnnnnddddiaaaaaaaaaaaaaaaaaaaaaaaaaa
aaaaaaaaaaaaaaaaaaaaaaaaamdddddddddddddddddiaaaaaaaaaaaaaaaaaaaaaaaaaa
aaaaaaaaaaaaaaaaaaaaaaaaamdddddddddddddddddiaaaaaaaaaaaaaaaaaaaaaaaaaa
aaaaaaaaaaaaaaaaaaaaaaaaamdddooooooooooddddiaaaaaaaaaaaaaaaaaaaaaaaaaa
aaaaaaaaaaaaaaaaaaaaaaaaamdddddddddddddddddiaaaaaaaaaaaaaaaaaaaaaaaaaa
aaaaaaaaaaaaaaaaaaaaaaaaamddddddddddddddpddiaaaaaaaaaaaaaaaaaaaaaaaaaa
aaaaaaaaaaaaaaaaaaaaaaaaamdddqqqqqqqqqqddddiaaaaaaaaaaaaaaaaaaaaaaaaaa
aaaaaaaaaaaaaaaaaaaaaaaaadddddddddddddddddddaaaaaaaaaaaaaaaaaaaaaaaaaa
aaaaaaaaaaaaaaaaaaaaaaaaalrrrrrrrrrrrrrrrrrsaaaaaaaaaaaaaaaaaaaaaaaaaa
aaaaaaaaaaaaaaaaaaaaaaaaadrrrrrrrrrrrrrrrrrdaaaaaaaaaaaaaaaaaaaaaaaaaa
aaaaaaaaaaaaaaaaaaaaaaaaadrrdddddDDDdddddrrdaaaaaaaaaaaaaaaaaaaaaaaaaa
aaaaaaaaaaaaaaaaaaaaaaaaadrrDDDDDDtDDDDDDrrdaaaaaaaaaaaaaaaaaaaaaaaaaa
aaaaaaaaaaaaaaaaaaaaaaaaadrruvvvvvvvvvvvwrrdaaaaaaaaaaaaaaaaaaaaaaaaaa
aaaaaaaaaaaaaaaaaaaaaaaaadrruvvvvvvvvvvvwrrdaaaaaaaaaaaaaaaaaaaaaaaaaa
aaaaaaaaaaaaaaaaaaaaaaaaadrruvvvvvvvvvvvwrrdaaaaaaaaaaaaaaaaaaaaaaaaaa
aaaaaaaaaaaaaaaaaaaaaaaaadrruvvvvvvvvvvvwrrdaaaaaaaaaaaaaaaaaaaaaaaaaa
aaaaaaaaaaaaaaaaaaaaaaaaadrruvvvvvvvvvvvwrrdaaaaaaaaaaaaaaaaaaaaaaaaaa
aaaaaaaaaaaaaaaaaaaaaaaaalrruvvvvvxvvvvvwrrsaaaaaaaaaaaaaaaaaaaaaaaaaa
aaaaaaaaaaaaaaaaaaaaaaaaadrruvvvvvvvvvvvwrrdaaaaaaaaaaaaaaaaaaaaaaaaaa
aaaaaaaaaaaaaaaaaaaaaaaaadrruvvvvvvvvvvvwrrdaaaaaaaaaaaaaaaaaaaaaaaaaa
aaaaaaaaaaaaaaaaaaaaaaaaadrruvvvvvvvvvvvwrrdaaaaaaaaaaaaaaaaaaaaaaaaaa
aaaaaaaaaaaaaaaaaaaaaaaaadrruvvvvvvvvvvvwrrdaaaaaaaaaaaaaaaaaaaaaaaaaa
aaaaaaaaaaaaaaaaaaaaaaaaadrryvvvvvvvvvvvwrrdaaaaaaaaaaaaaaaaaaaaaaaaaa
aaaaaaaaaaaaaaaaaaaaaaaaadrrDzzzzzzzzzzzDrrdaaaaaaaaaaaaaaaaaaaaaaaaaa
aaaaaaaaaaaaaaaaaaaaaaaaadrrdddddddddddddrrdaaaaaaaaaaaaaaaaaaaaaaaaaa
aaaaaaaaaaaaaaaaaaaaaaaaadrrrrrrrrrrrrrrrrrdaaaaaaaaaaaaaaaaaaaaaaaaaa
aaaaaaaaaaaaaaaaaaaaaaaaaArrrrrrrrBrrrrrrrrAaaaaaaaaaaaaaaaaaaaaaaaaaa
aaaaaaaaaaaaaaaaaaaaaaaaaaaaaaaaaaaaaaaaaaaaaaaaaaaaaaaaaaaaaaaaaaaaaa
aaaaaaaaaaaaaaaaaaaaaaaaaaaaaaaaaaaaaaaaaaaaaaaaaaaaaaaaaaaaaaaaaaaaaa
aaaaaaaaaaaaaaaaaaaaaaaaaaaaaaaaaaaaaaaaaaaaaaaaaaaaaaaaaaaaaaaaaaaaaa
aaaaaaaaaaaaaaaaaaaaaaaaaaaaaaaaaaaaaaaaaaaaaaaaaaaaaaaaaaaaaaaaaaaaaa
aaaaaaaaaaaaaaaaaaaaaaaaaaaaaaaaaaaaaaaaaaaaaaaaaaaaaaaaaaaaaaaaaaaaaa
aaaaaaaaaaaaaaaaaaaaaaaaaaaaaaaaaaaaaaaaaaaaaaaaaaaaaaaaaaaaaaaaaaaaaa
aaaaaaaaaaaaaaaaaaaaaaaaaaaaaaaaaaaaaaaaaaaaaaaaaaaaaaaaaaaaaaaaaaaaaa
aaaaaaaaaaaaaaaaaaaaaaaaaaaaaaaaaaaaaaaaaaaaaaaaaaaaaaaaaaaaaaaaaaaaaa
aaaaaaaaaaaaaaaaaaaaaaaaaaaaaaaaaaaaaaaaaaaaaaaaaaaaaaaaaaaaaaaaaaaaaa
aaaaaaaaaaaaaaaaaaaaaaaaaaaaaaaaaaaaaaaaaaaaaaaaaaaaaaaaaaaaaaaaaaaaaa
aaaaaaaaaaaaaaaaaaaaaaaaaaaaaaaaaaaaaaaaaaaaaaaaaaaaaaaaaaaaaaaaaaaaaa
aaaaaaaaaaaaaaaaaaaaaaaaaaaaaaaaaaaaaaaaaaaaaaaaaaaaaaaaaaaaaaaaaaaaaa
aaaaaaaaaaaaaaaaaaaaaaaaaaaaaaaaaaaaaaaaaaaaaaaaaaaaaaaaaaaaaaaaaaaaaa
aaaaaaaaaaaaaaaaaaaaaaaaaaaaaaaaaaaaaaaaaaaaaaaaaaaaaaaaaaaaaaaaaaaaaa
aaaaaaaaaaaaaaaaaaaaaaaaaaaaaaaaaaaaaaaaaaaaaaaaaaaaaaaaaaaaaaaaaaaaaa
aaaaaaaaaaaaaaaaaaaaaaaaaaaaaaaaaaaaaaaaaaaaaaaaaaaaaaaaaaaaaaaaaaaaaa
aaaaaaaaaaaaaaaaaaaaaaaaaaaaaaaaaaaaaaaaaaaaaaaaaaaaaaaaaaaaaaaaaaaaaa
aaaaaaaaaaaaaaaaaaaaaaaaaaaaaaaaaaaaaaaaaaaaaaaaaaaaaaaaaaaaaaaaaaaaaa
aaaaaaaaaaaaaaaaaaaaaaaaaaaaaaaaaaaaaaaaaaaaaaaaaaaaaaaaaaaaaaaaaaaaaa
aaaaaaaaaaaaaaaaaaaaaaaaaaaaaaaaaaaaaaaaaaaaaaaaaaaaaaaaaaaaaaaaaaaaaa
aaaaaaaaaaaaaaaaaaaaaaaaaaaaaaaaaaaaaaaaaaaaaaaaaaaaaaaaaaaaaaaaaaaaaa
aaaaaaaaaaaaaaaaaaaaaaaaaaaaaaaaaaaaaaaaaaaaaaaaaaaaaaaaaaaaaaaaaaaaaa
aaaaaaaaaaaaaaaaaaaaaaaaaaaaaaaaaaaaaaaaaaaaaaaaaaaaaaaaaaaaaaaaaaaaaa
aaaaaaaaaaaaaaaaaaaaaaaaaaaaaaaaaaaaaaaaaaaaaaaaaaaaaaaaaaaaaaaaaaaaaa
Caaaaaaaaaaaaaaaaaaaaaaaaaaaaaaaaaaaaaaaaaaaaaaaaaaaaaaaaaaaaaaaaaaaaa
"}
