"aa" = (/turf/floor/dirt,/area/prishtina)
"ab" = (/turf/floor/plating/asteroid,/area/prishtina)
"ac" = (/turf/floor/plating/dust,/area/prishtina)
"ad" = (/turf/floor/dirt/darksand,/area/prishtina)
"ae" = (/turf/floor/dirt{icon_state = "oldsmoothdarkdirt"},/area/prishtina)
"af" = (/turf/floor/dirt{icon_state = "asteroid10"},/area/prishtina)
"ag" = (/obj/structure/barbwire{dir = 4},/obj/structure/anti_tank,/turf/floor/dirt,/area/prishtina)
"ah" = (/obj/structure/barbwire{dir = 4},/turf/floor/dirt,/area/prishtina)
"ai" = (/obj/structure/window/sandbag,/turf/floor/dirt,/area/prishtina)
"aj" = (/turf/wall/rockwall{density = 1; name = "cliff"; opacity = 1},/area/prishtina)
"ak" = (/obj/structure/wild/burnedbush,/turf/floor/dirt,/area/prishtina)
"al" = (/obj/structure/wild/burnedtree,/turf/floor/dirt,/area/prishtina)
"am" = (/obj/structure/wild/rock,/turf/floor/dirt,/area/prishtina)
"an" = (/obj/structure/wild/tallgrass2,/turf/floor/dirt,/area/prishtina)
"ao" = (/obj/structure/wild/jungle,/turf/floor/plating/grass/wild,/area/prishtina)
"ap" = (/turf/wall/rockwall,/area/prishtina)
"aq" = (/obj/structure/wild/bush/tame/big{name = "large bush"},/turf/floor/plating/grass/wild,/area/prishtina)
"ar" = (/obj/structure/wild/tallgrass,/turf/floor/plating/grass/wild,/area/prishtina)
"as" = (/obj/structure/wild/palm,/turf/floor/plating/grass/wild,/area/prishtina)
"at" = (/obj/structure/wild/tree,/turf/floor/plating/grass/wild,/area/prishtina)
"au" = (/obj/structure/wild/bush,/turf/floor/plating/grass/wild,/area/prishtina)
"av" = (/obj/structure/wild/palm,/obj/structure/wild/jungle,/turf/floor/plating/grass/wild,/area/prishtina)
"aw" = (/obj/structure/wild/palm,/obj/structure/wild/largejungle,/turf/floor/plating/grass/wild,/area/prishtina)
"ax" = (/obj/structure/wild/junglebush,/turf/floor/plating/grass/wild,/area/prishtina)
"ay" = (/obj/effect/overlay/coconut,/turf/floor/plating/grass/wild,/area/prishtina)
"az" = (/obj/structure/wild/tree,/obj/structure/wild/jungle,/turf/floor/plating/grass/wild,/area/prishtina)
"aA" = (/obj/structure/wild/tree/anchored,/turf/floor/plating/grass/wild,/area/prishtina)
"aB" = (/turf/floor/plating/dirt,/area/prishtina)
"aC" = (/obj/structure/wild/junglebush,/obj/structure/wild/largejungle,/turf/floor/plating/grass/wild,/area/prishtina)
"aD" = (/obj/structure/wild/bush,/obj/structure/wild/largejungle,/turf/floor/plating/grass/wild,/area/prishtina)
"aE" = (/obj/structure/wild/palm,/obj/structure/wild/largejungle,/turf/floor/plating/dust,/area/prishtina)
"aF" = (/obj/structure/wild/bush/tame/big{name = "large bush"},/obj/structure/wild/largejungle,/turf/floor/plating/grass/wild,/area/prishtina)
"aG" = (/obj/structure/closet/cabinet{anchored = 1; desc = "Something looks strange in this bush..."; icon = 'icons/obj/wild.dmi'; icon_closed = "small_bush"; icon_opened = "small_bush"; icon_state = "small_bush"; name = "weird bush"; opened = 1},/turf/floor/plating/grass/wild,/area/prishtina)
"bB" = (/turf/floor/dirt/dust,/area/prishtina)
"bS" = (/turf/floor/plating/grass/wild,/area/prishtina)

(1,1,1) = {"
aaaaaaaaaaaaaaaaaaaaaaaaaaaaaaaaaaaaaaaaaaaaaaaaaaaaaaaaaaaaaaaaaaaaaaaaaaaaaaaaaaaaaaaaaaaaaaaaaaaaaaaaaaaaaaaaaaaaaaaaaaaaaaaaaaaaaaaaaaaa
aaaaaaaaaaaaaaaaaaaaaaaaaaaaaaaaaaaaaaaaaaaaaaaaaaaaaaaaaaaaaaaaaaaaaaaaaaaaaaaaaaaaaaaaaaaaaaaaaaaaaaaaaaaaaaaaaaaaaaaaaaaaaaaaaaaaaaaaaaaa
aaaaaaaaaaaaaaaaaaaaaaaaaaaaaaaaaaaaaaaaaaaaaaaaaaaaaaaaaaaaaaaaaaaaaaaaaaaaaaaaaaaaaaaaaaaaaaaaaaaaaaaaaaaaaaaaaaaaaaaaaaaaaaaaaaaaaaaaaaaa
aaaaaaaaaaaaaaaaaaaaaaaaaaaaaaaaaaaaaaaaaaaaaaaaaaaaaaaaaaaaaaaaaaaaaaaaaaaaaaaaaaaaaaaaaaaaaaaaaaaaaaaaaaaaaaaaaaaaaaaaaaaaaaaaaaaaaaaaaaaa
aaaaaaaaaaaaaaaaaaaaaaaaaaaaaaaaaaaaaaaaaaaaaaaaaaaaaaaaaaaaaaaaaaaaaaaaaaaaaaaaaaaaaaaaaaaaaaaaaaaaaaaaaaaaaaaaaaaaaaaaaaaaaaaaaaaaaaaaaaaa
aaaaaaaaaaaaaaaaaaaaaaaaaaaaaaaaaaaaaaaaaaaaaaaaaaaaaaaaaaaaaaaaaaaaaaaaaaaaaaaaaaaaaaaaaaaaaaaaaaaaaaaaaaaaaaaaaaaaaaaaaaaaaaaaaaaaaaaaaaaa
aaaaaaaaaaaaaaaaaaaaaaaaaaaaaaaaaaaaaaaaaaaaaaaaaaaaaaaaaaaaaaaaaaaaaaaaaaaaaaaaaaaaaaaaaaaaaaaaaaaaaaaaaaaaaaaaaaaaaaaaaaaaaaaaaaaaaaaaaaaa
aaaaadadadadadadadadaaaaaaaaaaaaaaaaaaaaaaaaaaaaaaaaaaaaaaaaaaaaaaaaaaaaaaaaaaaaaaaaaaaaaaaaaaaaaaaaaaaaaaaaaaaaaaaaaaaaaaaaaaaaaaaaaaaaaaaa
aaadadaeaeaeafafaeaeadadadaaaaaaaaaaaaaaaaaaaaaaaaaaaaaaaaaaaaaaaaaaaaaaaaaaaaaaaaaaaaaaaaaaaaaaaaaaaaaaaaaaaaaaaaaaaaaaaaaaaaaaaaaaaaaaaaaa
aaadaeaeaeafafafaeaeaeaeaeadaaaaaaaaaaaaaaaaaaaaaaaaaaaaaaaaaaaaaaaaaaaaaaaaaaaaaaaaaaaaaaaaaaaaaaaaaaaaaaaaaaaaaaaaaaaaaaaaaaaaaaaaaaaaaaaa
aaadadadadadaeafafadadadadadaaaaaaaaaaaaaaaaaaaaaabSbSbSbSbSbSbSbSbSbSbSbSbSbSbSbSbSbSbSbSbSbSbSbSbSbSbSbSaaaaaaaaaaaaaaaaaaaaaaaaaaaaaaaaaa
aaaaaaaaadadadadadadadadaaaaaaaaaaaaaaaaaaaaaaaaaabSbSbSbSbSbSbSbSbSbSbSbSbSbSbSbSbSbSbSbSbSbSbSbSbSbSbSbSaaaaaaaaaaaaaaaaaaaaaaaaaaaaaaaaaa
aaaaaaaaaaaaaaaaaaaaaaaaaaaaaaaaaaaaaaaaaaaaaaaabSbSbSbSbSbSbSbSbSbSbSbSbSbSbSbSbSbSbSbSbSbSbSbSbSbSbSbSbSaaaaaaaaaaaaaaaaaaaaaaaaaaaaaaaaaa
aaaaaaaaaaaaaaaaaaaaaaaaaaaaaaaaaaaaaaaaaaaaaaaaaaaabSbSbSbSbSbSbSbSbSbSbSbSbSbSbSbSbSbSbSbSbSbSbSbSbSaabSaaaaaaaaaaaaaaaaaaaaaaaaaaaaaaaaaa
aaaaaaaaaaaaaaaaaaaaaaaaaaaaaaaaaaaaaaaaaaaabSbSaaaaaaaaaaaaaaaaaaaaaaaaaaaaaaaaaaaaaaaaaaaaaaaaaaaabSaabSaaaaaaaaaaaaaaaaaaaaaaaaaaaaaaaaaa
aaaaaaaaaaaaaaaaaaaaaaaaaaaaaaaaaaaaaaaaaaaaaaaaaaaaaaaaaaaaaaagahahahahagaiaiaiagahahahahahahahagaabSaabSaaaaaaaaaaaaaaaaaaaaaaaaaaaaaaaaaa
aaaaaaaaaaaaaaaaaaaaaaaaaaaaaaaaaaaaaaaaaaaaaaaaaaaaahahahagaiaiaaaaaaaaaaaaaaaaaaaaaaaaaaaaaaaaaaaabSaaaaaaaaaaaaaaaaaaaaaaaaaaaaaaaaaaaaaa
aaaaaaaaaaaaaaaaaaaaaaaaaaaaaaaaaaaaaaaaaaaaaaaabSbSaaaaaaaaaaaaaaaaaaaaaaaaaaaaaaaaaaaaaaaaaaaaaaaabSaaaaaaaaaaaaaaaaaaaaaaaaaaaaaaaaaaaaaa
aaaaaaaaaaaaaaaaaaaaaaaaaaaaaaaaaaaaaaaaaaaaaaaabSaabSaaaaaaaaaaaaaaaaaaaiaiagahahahahagaiaiaiaaaaaabSaaaaaaaaaaaaaaaaaaaaaaaaaaaaaaaaaaaaaa
aaaaaaaaaaaaaaaaaaaaaaaaaaaaaaaaaaaaaaaaaaaaaaaaaaaaaaaaaaaaaaaaaaaaaaaaaaaaaaaaaaaaaaaaaaaaaaaaaaaaaaaaaaaaaaaaaaaaaaaaaaaaaaaaaaaaaaaaaaaa
bBbBaaaaaaaaaaaaaaaaaaaaaaaaaaaaaaaaaaaaaaaaaaaaaaaaaaaaaaaaaaaaaaaaaaaaaaaaaaaaaaaaaaaaaaaaaaaaaaaaaaaaaaaaaaaaaaaaaaaaaaaaaaaaaaaaaaaaaaaa
ajajajaaaaaaaaaaaaaaaaaaaaaaaaaaaaaaaaaaaaaaaaaaaaaaaaaaaaaaaaaaaaaaaaaaaaaaaaaaaaaaaaaaaaaaaaaaaaaaaaaaaaaaaaaaaaaaaaaaaaaaaaaaaaaaaaaaaaaa
ajajajbBaaaaaaaaaaaaaaaaaaaaaaaaaaaaaaaaaaaaaaaaaaaaaaaaaaaaaaaaaaaaaaaaaaaaaaaaaaaaaaaaaaaaaaaaaaaaaaaaaaaaaaaaaaaaaaaaaaaaaaaaaaaaaaaaaaaa
ajajaaajbBaaaaaaaaaaaaaaaaaaaaaaaaaaaaaaaaaaaaaaaaaaaaaaaaaaaaaaaaaaaaaaaaaaaaaaaaaaaaaaaaaaaaaaaaaaaaaaaaaaaaaaaaaaaaaaaaaaaaaaaaaaaaaaaaaa
ajajajajajbBbBaaaaaaaaaaaaaaaaaaaaaaaaaaaaaaaaaaaaaaaaaaaaaaaaaaaaaaaaaaaaaaaaaaaaaaaaaaaaaaaaaaaaaaaaaaaaaaaaaaaaaaaaaaaaaaaaaaaaaaaaaaaaaa
ajajajajajajajbBbBaaaaaaaaaaaaaaaaaaaaaaaaaaaaaaaaaaaaaaaaaaaaaaaaaaaaaaaaaaaaaaaaaaaaaaaaaaaaaaaaaaaaaaaaaaaaaaaaaaaaaaaaaaaaaaaaaaaaaaaaaa
ajajajajajajajbBbBaaaaaaaaaaaaaaaaaaaaaaaaaaaaaaaaaaaaaaaaaaaaaaaaaaaaaaaaaaaaaaaaaaaaaaaaaaaaaaaaaaaaaaaaaaaaaaaaaaaaaaaaaaaaaaaaaaaaaaaaaa
ajajajajajajajbBajbBaaaaaaaaaaaaaaaaaaaaaaaaaaaaaaaaaaaaaaaaaaaaaaaaaaaaaaaaaaaaaaaaaaaaaaaaaaaaaaaaaaaaaaaaaaaaaaaaaaaaaaaaaaaaaaaaaaaaaaaa
aaajajajajajajajajbBajaaaaaaaaaaaaaaaaaaaaaaaaaaaaaaaaaaaaaaaaaaaaaaaaaaaaaaaaaaaaaaaaaaaaaaaaaaaaaaaaaaaaaaaaaaaaaaaaaaaaaaaaaaaaaaaaaaaaaa
ajajajajajajajajajajajaaaaaaaaaaaaaaaaaaaaaaaaaaaaaaaaaaaaaaaaaaaaaaaaaaaaaaaaaaaaaaaaaaaaaaaaaaaaaaaaaaaaaaaaaaaaaaaaaaaaaaaaaaaaaaaaaaaaaa
ajajajajajaaaaaaaaaaajbBajaaaaaaaaaaaaaaaaaaaaaaaaaaaaaaaaaaaaaaaaaaaaaaaaaaaaaaaaaaaaaaaaaaaaaaaaaaaaaaaaaaaaaaaaaaaaaaaaaaaaaaaaaaaaaaaaaa
ajajaaaaaabBbBajajajajajajbBaaaaaaaaaaaaaaaaaaaaaaaaaaaaaaaaaaaaaaaaaaaaaaaaaaaaaaaaaaaaaaaaaaaaaaaaaaaaaaaaaaaaaaaaaaaaaaaaaaaaaaaaaaaaaaaa
ajajajaaajajaaaaajajajajaaajajaaaaaaaaaaaaaaaaaaaaaaaaaaaaaaaaaaaaaaaaaaaaaaaaaaaaaaaaaaaaaaaaaaaaaaaaaaaaaaaaaaaaaaaaaaaaaaaaaaaaaaaaaaaaaa
ajajajajajaaaaaaajajaaaaaabBajaaaaadaabBaaaaaaaaaaaaaaaaaaaaaaaaaaaaaaaaaaaaaaaaaaaaaaaaaaaaaaaaaaaaaaaaaaaaaaaaaaaaaaaaaaaaaaaaaaaaaaaaaaaa
ajajbBaaajajajaaajaaaaajaaaaaaaaadaebBadadbBaaaaaaaaaaaaaaaaaaaaaaaaaaaaaaaaaaaaaaaaaaaaaaaaaaaaaaaaaaaaaaaaaaaaaaaaaaaaaaaaaaaaaaaaaaaaaaaa
aaaabBaaaaaaaaaaakaaaaaaaaaaalbBadaeadaeaebBaaaaaaaaaaaaaaaaaaaaaaaaaaaaaaaaaaaaaaaaaaaaaaaaaaaaaaaaaaaaaaaaaaaaaaaaaaaaaaaaaaaaaaaaaaaaaaaa
ajaabBajaaajajajaabBaaaaaaaaaabBbBaeadafafaeadaaaaaaalaaaaaaaaaaaaaaaaaaaaaaaaaaaaaaaaaaaaaaaaaaaaaaaaaaaaaaaaaaaaaaaaaaaaaaaaaaaaaaaaaaaaaa
aaajajaaaaaaaabBbBaaaaakaaaaaaaaadaeafafadaeadaaaaaaaaaaaaaaaaaaaaaaaaaaaaaaaaaaaaaaaaaaaaaaaaaaaaaaaaaaaaaaaaaaaaaaaaaaaaaaaaaaaaaaaaaaaaaa
aaajajajajajbBbBaaaaaaaaalaaaabBadaeaeaeaeaebBbBaaaaaaaaaaaaaaaaaaaaaaaaaaaaaaaaaaaaaaaaaaaaaaaaaaaaaaaaaaaaaaaaaaaaaaaaaaaaaaaaaaaaaaaaaaaa
aaajajajaaaaaaaaaaaaaaamaaaaakaabBadadbBadaaadaaaaaaaaaaaaaaaaaaaaaaaaaaaaaaaaaaaaaaaaaaaaaaaaaaaaaaaaaaaaaaaaaaaaaaaaaaaaaaaaaaaaaaaaaaaaaa
aabBbBbBbBbBaaaaaaaaaaaaanaaaaalaaaaaabBaaaaaaaaaaaaaaaaaaaaaaaaaaaaaaaaaaaaaaaaaaaaaaaaaaaaaaaaaaaaaaaaaaaaaaaaaaaaaaaaaaaaaaaaaaaaaaaaaaaa
bBbBbBaaaaaaaaaaaaaaakaaaaaaaaaaaaaaaaaaaaaaaaaaaaaaaaaaaaaaaaaaaaaaaaaaaaaaaaaaaaaaaaaaaaaaaaaaaaaaaaaaaaaaaaaabSaaaaaaaaaaaaaaaaaaaaaaaaaa
aaaaaaaaaaaaaaaaaaaaaaaaaaamaaaaaaaaaaaaaaakaaaaaaaaaaaaaaaaaaaaaaaaaaaaaaaaaaaaaaaaaaaaaaaaaaaaaaaaaaaaaaaaaaaobSbSaaaaaaaaaaaaaaaaaaaaaaaa
aaaaaaaaaaaaaaaaaaanaaaaakaaaaanaaaaalaaaaaaalaaaaaaaaaaaaaaaaaaaaaaaaaaaaaaaaaaaaaaaaaaaaaaaaaaaaaaaaaaaaaaaabSbSaaaaaaaaaaaaaaaaaaaaaaaaaa
aaaaaaaaaaapaaaaaaaaaaaaaaaaanaaaaaaaaaaaaaaaaaaaaaaaaakaaaaaaaaaaaaaaaaaaaaaaaaaaaaaaaaaaaaaaaaaaaaaaaaaaaaaaaabSaaaaaaaaaaaaaaaaaaaaaaaaaa
aaaaaaaaaaapapaaaaaaaaaaanaaaaaaakaaaaaaaaaaaaaaaaaaaaaaaaaaaaaaaaaaaaaaaaaaaaaaaaaaaaaaaaaaaaaaaaaaaaaaaaaaaaaabSaaaaaaaaaaaaaaaaaaaaaaaaaa
aaaaaaaaaaaaapapapapapapapapaaaaaaaaaaaaaaaaaaaaaaaaaaaaaaaaaaaaaaaaaaaaaaaaaaaaaaaaaaaaaaaaaaaaaaaaaaaaaaaaaaaaaaaaaaaaaaaaaaaaaaaaaaaaaaaa
apadadaaaaaaapadadapadadapapapapapapapapapaaaaaaaaaaaaaaaaaaaaaaaaaaaaaaaaaaaaaaaaaaaaaaaaaaaaaaaaaaaaaaaaaaacacacacaaaaacacacacacacacaaacac
apaaaaaaaaaaapapapapapadadadapaaadaaapapapaaaaaaaaaaaaaaaaaaaaaaaaaaaaaaaaaaaaaaaaaaaaaaaaaaaaaaaaaaaaaaaaaaacacacacbSbSbSbSbSaaaaacbSbSaaaa
apaaaaaaadaaapapapapapapapadapaaaaaaapapapaaaaaaaaaaaaaaaaaaaaaaaaaaaaacacacacaaacacacacacbSbSacacbSaaaaaabSbSbSbSbSbSbSbSbSbSbSbSacaqbSaras
apaaapaaaaaaaaaaapapadadadadapaaapadapapapapapaaaaaaaaaaaaaaaaaabSbSbSbSbSacbSbSbSacbSbSaaaaaaacacaaacacaaasbSbSbSbSbSbSbSbSbSbSbSbSataubSat
apaaaaadaaaaaaaaaaaaaaapadapapaaapaaapapapapapaaaaaaaaaaaaaaaaaabSbSbSbSbSauaqasasbSavasaqaqbSarasbSbSbSbSbSbSbSbSbSbSbSbSbSbSaqasarbSbSbSbS
apaaaaaaaaadaaaaaaapapaaaaaaadadaaadapapapapapaaaaaaaaaaaaaaaaaaasbSasasbSbSaqasbSbSaubSbSataubSatavasaqaqasbSaubSbSbSbSbSbSbSbSbSbSatasasbS
apaaaaaaaaaaaaaaaaapapaaaaapababaaaaapapapapapaaaaaaaaaaaaaaaaaabSbSbSbSawaqbSbSatbSaqasarbSbSbSbSaubSbSatbSaoaxbSbSbSbSbSbSbSaoaqayaybSazat
apaaapapaaaaaaaaaaaaaaaaaaapababapapapapapapapaaaaaaaaaaaaaaaaaaasbSauaxbSbSaraAbSasbSbSbSatasasbSaqasarbSbSbSaobSbSbSbSbSbSbSasbSbSbSbSbSbS
apaaapapaaaaaaaaapapaaapapaaabapapapapapapapapaaaaaaaaaaaaaaaaaabSaoaxataAbSbSbSbSauaoaqayaybSazatbSbSbSatbSatbSbSbSbSbSbSbSbSbSbSbSbSbSbSbS
apaaadaaaaaaaaaaapapaaapaaapaaapapaaapapapaaaaaaaaaaaaaaaaaaaabSbSbSaobSbSasasbSaxbSasbSbSbSbSaqataoaqbSbSaqbSasbSbSbSbSbSbSbSbSbSbSbSbSbSaB
apaaaaaaapapaaaaapapadaaaaapaaapapaaapapapapapapaaaaaaaaaaaaaabSbSatbSbSbSaCbSasbSaqarbSaAbSbSbSbSbSbSbSbSaDbSbSbSbSbSbSbSbSbSbSbSbSbSbSacac
apaaadaaapapaaaaaaaaaaaaapapaaaaaaaaapapapapapapapaaaaaaaaaaaabSaqbSasbSasbSbSasasbSbSbSbSbSbSbSaBbSbSbSbSbSbSbSbSbSbSbSbSbSbSbSbSbSbSbSacac
apaaadaaapapaaaaaaaaaaaaapapaaaaaaaaapapapapapapapaaaaaaaaaaaaaaaDbSbSbSbSaAbSbSbSbSbSbSbSbSbSbSaBbSbSbSbSbSbSbSbSbSbSbSbSbSbSbSbSbSbSbSacac
apaaaaaaaaaaaaaaaaadaaaaapapaaaaadaaapapapapaaaaaaaaaaaaaaaabSbSbSaAaxbSasaobSbSbSbSbSbSbSbSbSbSaBbSbSbSbSbSbSbSbSbSbSbSbSbSbSbSbSbSbSbSbSaB
apaaadaaaaapapaaadadadadadaaaaaaaaaaapapapaaaaaaaaaaaaaaaaaabSasbSasasbSbSaqasbSbSbSbSbSbSbSbSbSbSbSbSbSbSbSbSbSbSbSbSbSbSbSbSbSbSbSbSbSbSaB
apaaadaaaaapapadabadababadaaaaadadadadapapapaaaaaaaaaaaaaaaabSbSbSbSbSaEaqbSbSbSbSbSbSbSbSbSbSbSbSbSbSbSbSbSbSbSbSbSbSbSbSbSbSbSbSbSbSbSbSbS
apaaaaaaaaaaaaaaadadadadadaaaaadababadadapapaaaaaaaaaaaaaaaabSasbSauaxacbSarbSbSbSbSbSbSbSbSbSbSbSbSbSbSbSbSbSbSbSbSbSbSbSbSbSbSbSbSaBbSbSbS
apaaaaaaapaaaaaaaaadabababadaaababaaadabadaaaaaaaaaaaaaaaaaaaabSaoaxataAbSbSbSbSbSbSbSbSbSbSbSbSbSbSbSbSbSbSbSbSbSbSbSbSbSbSbSbSbSbSaBbSbSbS
apaaaaaaapaaadaaaaaaapaaaaaaaaaaadaaadadadadaaaaaaapaaaaacacaabSbSaobSbSasasbSbSbSbSbSbSbSbSbSbSbSbSbSbSbSbSbSbSbSbSbSbSbSbSbSbSbSbSaBbSbSbS
apaaadadaaaaaaaaaaaaaaaaaaaaaaapapapadadadadaaaaaaaaaaaaacacbSbSatbSbSbSaCbSbSbSbSbSbSbSbSbSbSbSbSbSbSbSbSbSbSbSbSbSbSbSbSbSbSbSbSbSbSbSbSbS
apaaaaaaaaaaaaaaaaadaaaaaaapaaapapapapaaapaaaaaaaaaaaaaaaaacbSaqbSasbSasbSbSasasbSbSbSbSbSbSbSaBbSbSbSbSbSbSaBbSbSbSbSbSbSaBbSbSbSbSbSbSbSaB
apaaaaadaaadadadaaaaaaaaaaapaaaaaaaaaaapapaaaaaaaaaaaaaaaaacbSaDbSbSbSbSaAbSbSaqaxasaFbSasbSbSaBbSbSbSbSbSbSaBbSbSbSbSbSbSaBbSbSbSbSbSbSbSaB
apapapapapapapapapapapapapapapapapapapaaapaaaaaaaaaaaaaaaaaabSbSaAaxbSasaobSbSbSbSarbSaraGbSbSaBbSbSbSbSbSbSaBbSbSbSbSbSbSaBbSbSbSbSbSbSbSaB
"}
