"a" = (/turf/floor/plating/grass/wild,/area/prishtina)
"b" = (/obj/structure/wild/tallgrass,/turf/floor/plating/grass/wild,/area/prishtina)
"c" = (/obj/structure/wild/tallgrass,/obj/structure/wild/tallgrass,/turf/floor/plating/grass/wild,/area/prishtina)
"d" = (/obj/structure/wild/tree/live_tree,/turf/floor/plating/grass/wild,/area/prishtina)
"e" = (/obj/structure/wild/rock,/turf/floor/plating/grass/wild,/area/prishtina)
"f" = (/obj/structure/wild/tree/live_tree,/obj/structure/wild/tallgrass,/turf/floor/plating/grass/wild,/area/prishtina)
"g" = (/obj/structure/wild/bush{icon_state = "grassybush_1"},/turf/floor/plating/grass/wild,/area/prishtina)
"h" = (/obj/structure/wild/tallgrass2,/turf/floor/plating/grass/wild,/area/prishtina)
"i" = (/obj/structure/wild/tallgrass,/obj/structure/wild/bush{icon_state = "grassybush_1"},/turf/floor/plating/grass/wild,/area/prishtina)
"j" = (/obj/structure/wild/tallgrass,/obj/structure/wild/tallgrass,/obj/structure/wild/tallgrass,/turf/floor/plating/grass/wild,/area/prishtina)
"k" = (/obj/structure/wild/tallgrass,/obj/structure/wild/rock,/turf/floor/plating/grass/wild,/area/prishtina)
"l" = (/obj/structure/wild/tallgrass,/obj/structure/wild/tallgrass2,/turf/floor/plating/grass/wild,/area/prishtina)
"m" = (/obj/structure/wild/tree/live_tree,/obj/structure/wild/tallgrass,/obj/structure/wild/tallgrass,/turf/floor/plating/grass/wild,/area/prishtina)
"n" = (/turf/floor/dirt,/area/prishtina)
"o" = (/turf/floor/dirt/dust,/area/prishtina)
"p" = (/turf/floor/dirt/darksand,/area/prishtina)
"q" = (/obj/structure/wild/tree/live_tree,/turf/floor/dirt/darksand,/area/prishtina)
"r" = (/obj/structure/wild/tallgrass,/turf/floor/dirt,/area/prishtina)
"s" = (/obj/structure/wild/tallgrass,/turf/floor/dirt/darksand,/area/prishtina)
"t" = (/obj/structure/wild/rock,/turf/floor/dirt,/area/prishtina)

(1,1,1) = {"
aaaaaaaaaaaaaaaaaaaaaaaaaaaaaaaaaaaaaaaaaaaaaaaaaaaaaaaaaaaaaaaaaaaaaaaaaaa
aaaaaaaaaaaaaaaaaaaaaaaaaaaaaaaaaaaaaaaaaaaaaaaaaaaaaaaaaaaaaaaaaaaaaaaaaaa
aaaabcaaaaaaaaaaaaaaaaaaaaaaaaaaaaaaaaaaaaaaaaaaaaaaaaaaaaaaaaaaaaaaaaaaaaa
aaabbbaaaaaabaaaaaaaaaaaaaaaaaaaaaaaaaaaaaaaaaaaaaaaaaaaaaaaaaaaaaaaaaaaaaa
aaabaabaaaaaabaabaaaaaaaaaaaaaaaaabbbbaaaaaaaaaaaaaaaaaaaaaaabaaabadaaaaaaa
aaaaaaabbaaaaaaabaaaaaaaaaaaaaaaaaaaaaaaaaaaaaaaaaaaaaaaaaaaaaaaaaaaaaaaaaa
aaaaaaaaaabaaaeaaaaaabfaaaabaaabaaaaaaaaaaaaaaaaaaaaaaaaaabbaaaaaaaabaaaaaa
aaaaadaaaaaaaaaaaaaaaaaaaaaaaaaaaadaaaaaaaaaaaaaaaaaadaaaaaaaaaaaaaaabaaaaa
aaaaaeaaaaaaaabaaaaaaaaaaaaaaaaaaaaaaaaaaaaaaaaaaaabaaaababaaaaaaaaaabaaaaa
aaaaagaaaaaaabbaaaaaaaaaaaaaaaaaaaaaaaaaaaaaaadaaaaaaaabaaaaaaaababaaaaaaaa
aaaaaaabaaaaaaaaaaaaaaaaaaaaaaaaaaaaaaaaaaaaaaaaaaaaaaaannnnannaaananaaaaaa
aaaaaaaabbaaaaaaaaaaaaaaaaaaaaaaaaaaaaaaaaaabaaaaaaaaabooaopaaoooaaqannnaaa
aaaaaaaaaaaaaaaaaaaaaaaaaaaaaaaabaabaabaaaabaaaaaaaannaooaaaaaaaoaoaaaapnaa
aaaaaaaaaaaaaaaaagabbaaaaaaaaaaaaaaaabaaaaaaaaaaaaaanaaaoaaaaaaaanbbbbaanaa
aaaaaaaaaaaaaaaaaaabaaaaaahaaaaaaaabaaaaaaaaaaaagaaaanoonaaaaanaaaaaabbaaaa
aagaaaaaaaaaaaaaeaaaaaaaaannaaaaaaaaaaaaaaaaaaaaaaaaaaaonnaaaaaaaaaaaaabaaa
aaaaaaaaaaaaaagaaaaaaaaaaapaooaannnbgapaaaaaaaaaeaaaaaaonaaaaaabaaaaaaabaaa
aaaadaaaaaabaaaaaaaaanaaanaooaannaanapppaaaabacaaaaaaaaaaaaaaabaaaaebiaaaaa
aaaaaaaaaaaaaaadaaaaaaannoaaaaeaaaaannnaonanabaaaadaaaanaaaaabaaaaaabaaaaaa
aaaaaaaaaaaaaaabaaaaaannaaaaaaaannaaaannaapaaoaaaaaaaaapaaaaaaaaaaaaaaaaaaa
aaaaaaaaaaaaaaaaaaaaaannoadaaaaaaaaaaaanaoooaonnnaaaaonnaaaaaaaaaaaaaaaaaaa
aaaahaaaaaaaaaaaabaaaaanoaaaaaaaaaaaaaaraaaanoapppaoonnaaaaaaaaaaaaaaaaaaaa
aaaaaaaaaaaaabbaabaaaaanoaaaaabaaaaaaagbaaaanaaananoaaaaaaadaaaabaaaaaaaaaa
aaaaaaaaaaaaaaaaaaaaaaaanaaaaaaaaaaaaaaaaaaaaaaaaanaaaabaaaagaaaabaaaaaaaaa
nnaaaaaaaaaabaaaabbaaaaaaaaaaaaaaaaaaaadaaaaaaaaaaaabcbbbaaaaaaaabbaaaaaaaa
nnnnnnannnaaaaaaaananaannaabaaaaaaaaaaaaaaaaaaaaaaaaaaaabaaaaaaaaaabaaaaaaa
aaapaaanaansnapnonaaaaanapaaaaaaaaaaaaaaaaaaaaaaaaaaaaaabbaaaaaeaaaaaaaaaaa
aapaanaaaaabaaaanaaaadannagabbababaaaaaaaaaaaaaaaaaaaaaaaabaaaaaaaaaaaabaaa
aaaaaaaaaaaaaaaaabbaaaaanaaabaaaacaaaaaaaaaaaaaaaaaaabbaaaaaaeaaaaaaaaabaaa
aaaaaaaaabdaaaaabaaaaaannaaaabaaaaaaaaeaaaaaaaaaaaaaabaaaagabaaaaaaaaaaaaaa
adaaaaaaaaaaaaaaaahaaaaanannaaaaaaaaaaaaaaaaaaaaaaaaabaaaaaabbaaaaaaaaaabaa
aaaaaaaaaaaaaaaaaaaaaananaaaaaabaaaaaaaaaaaagbdbaaaaaaaaaaaaaaadbbaaaaaabaa
aaaaaaaaaaaaaeaaaaaaaanaoaaaaabbaaadaaaaaaaaaaabbaaaaaaaaaaaaaaabbbaaaaaaaa
aaaaaaaaaaaaaaababaaaaapnraaaaaaeaaaaaaaaaaaaaaaaaaaaaaaaaaaaaaaaaabaaaaaaa
aaaaaaaaadaaaaaaaaaaaanooaaaaaaaabbaaaaaaaaaaaaaaaaaaaaaaaaaaaaaaaaaaaaaaaa
aaaaaaaaaaaaaaaaaaaaaanaobaaaaaaaaagaaaaaaaaeaaaagaaaaaaaaaaaaaaaaaaaaaabba
aaaaaaaaaaaaaaaaaaaaaaaooaaaaaaaaaaaaaaaaaaaaaaaaaaaaabaaaaaaaaaaaaaaaaaaaa
aaaaaaaaaaaaaaaaaaaadaaonaaaaaaaaaaaaaaaaaaaaaaaaaadaaaabaaaaaaaaaaaaaaaaaa
aaaaaaaaaaaaaaaaaeaaaaannaaabbaaaaaaaaaaaaaaaaaaaaaaaaaaaaaaaaaaaaaaaaaaaaa
aabaaaacbaaaaaaaaaaaaaaanaaaaaaaaaaaaaaaaaaaaaaaaaaaaaaaaaaaaaaaaaaaaaaaaaa
aabaaaacjbaaaaaaaaaaabannaaaaafaaaabaaaahaaaaaaaaaaaaaaaaabaaaaaaaaaaaaaaaa
aabaaadbbcaaaaaaabaaaaapanaaabaaaaabbdaaabaaaaaaaaaaaaaaaabbaaaaaaaaaaaaaaa
aahaaaaaaaaaaababaaaaaaanaaabaaaaaaaaaaabbaaaaaaaaaaeaaaabaaaaaaaaaaaaaaaaa
aabaaaaaaaaaabaaaannaaaaanaaaaannaaabbbbaaakaaaaaaaaaaaaabaabaaaaaaaaaaaaaa
aaaaaaaaaaaaabaaaanaaaaannaaannnnaaaababaaaaabaaaaaaeaaaaaaaaacaabaaaaaaaaa
aabaaaaaeaaaabaaaanannannannnnnanaaaaablaaaaaabaaaaaaaaaaaafaaaaaaabaaaaaaa
aabaaaaaaaaaaaaaanneaaannnnnnnnaannababbaaaaaaaaaaaaaaaaaaaaaaaaaaaabbannaa
aabaaaaaaannaannaaaaaaaanaaaaaaannnaaabaaaaaaaaaaaaaaaaaaaabaaaabnaaaaaaana
aaaaaaagaaaaaanaaaaaabaannaaabaaaanaaannaanabaaabaaaaaaaaaaaaaanaaaaaanaaan
aaabbaaaaannnanaababbbaanaaaaalaaaaaaanaaarraadbaaaaaaaaaaaaanaaaannaanaann
aaaabaaaaaanannaabaabdaanaaaaaaannnaaaannnaaaaaaaaaaaaaaaaaaananaabaaaaaaaa
aaaaaaaaanaaanadabbbaaanaabaaabaanaaaaanaaannaaanananpanpnanpnnnaaaabaaaaaa
aaaaaaaaanaananaaaaaaaaannabaabaaabdaaaaraaaannananaanaaaaaanaaaagaabdaaaaa
aaaaaaaaaannnaaaaaaaaaaaaaaabaaaaabaaaaabaaaaaaaaaaaaaaaaaannaaaaaacabaaaaa
aaaaaaaaaaanaaabaaabaaanaaaaaaaaaaaaaabbabaaaaaaaaaaaaaaaaaaaaabbabaabaaaaa
aaaaaaaaaaananabbacaaaanaaaaaabaaaaaaaabaaaaaaaaaaaaaaaaaaaadaaaaaaaaaaaaaa
aaaaaabaaaaanaambbbaaaaanaaaaaabaaaaaaaaaaaaaaaabbbaaaaaabaaaaaaacaaaaaaaaa
aaaaaabbbaaanaaaaaaaaaaaaaaaaaaaaagaaaaaaaaaaaaaaabaaaaaabaaaaaabaaaaaaaaaa
aaaaaaaabaaanaaaanaaaaaaaaaaaaaaabaaaabaaaaaaaaaaabbadaaabaaaaaabagabaaaaaa
aaaaabcabaaaannaanabbbaaaaaaaaaaacbabaaaaaaaaaaaaaaabbalaaaaaaaaaaaaaaaaaaa
aadaaabaaganannnnaabbcaaaaaaaaadaaaaaaaaaaaaaaaaaaaabaaaaaaaaaaaaaaaaaaaaaa
aaaaaacbaannaapnnaablccldaaaaaaaaaaaaaagaaaaaaaabaaaabaaaaaaabbbaaaaaabaaaa
aaaaaaaaaannnnnnaaalbjcbaaaagaaabbbaaaaaaaaaaaaaabbaaaaaaaaaaaaaaaaaaaabaaa
aaaaaaaaaanaaaannnabaabaaaaaaaaaaaaaaaaaadaaaaaaaabaaaaaaaahaaaaaaaaaaadaaa
aaaaaaaaaaaannnnaabbaanaaaaaaaabbeaaaaaaaaaaaaaaaaaaaaaaaaaaaaaaaaaaaaaaaaa
aaaaaaaaaaanaaaaaaaaannnnaaaaaaaabbbaaaaaaaaaaaaaaaaaaaaaaaaaaaaaaaahaaaaaa
aaaaaaaadaannannnnaaanaatnaaaaaaaaaaaaaaaaaaaaaaaaaaaaaaaaaaaaaaaaaaaaabaaa
aaaaaaaaaaaaanpnanaaananpaaaaaadaaaaaaaabaaaaaaaaaaaadaaaaaaaaaaaaaaaaaahaa
aaaaaaaaaaaaannnnaaaaannaannaaaaaaaaaaaaaaaaaaaaaaaaaaaaaaaaaaadaaaaaaalhaa
aaahaaaaaagaaaaandaaaaaaannaaaaaaaaaaaaaabaaaaaaaaaaaaaaaaaaaaaaaaaaaaaaaaa
aaaaaaaaaaaaaaaaaaaaaaananagaaaaaaaaaaaaaaaaaaaaaaaaaaaaaggaaaaaaeaaaaabaaa
aaaaaaaaeaaaaaahaaaaeaanaaaaaaaaaaaaaaabbaaaaaaaaaaaaaaaaaaaabaaaaaaaaabaaa
aaaaaaaaaaaaaaaaaaaaaaaaaaaaaaaaaaabbabaaaaaaaaaeaaaaaaaaaaaaaaaabaaaaabaea
aaaaaaaaaaaaaaaaaaaaaaaaaaaaaaaaaaaaaaaaaaaaaaaaaaaaaaaaaaaaaaaaabbbaaaaaaa
aaaaaaaaaaaaaaaaaaaaaaaaaaaaaaaaabbabaaaabbbbaaabbaaaaaaaaaaaaaaaaaaaaaaaaa
"}
